second,avg_latency_ms_consul_v0.6.4,throughput_consul_v0.6.4,cumulative_throughput_consul_v0.6.4,avg_cpu_consul_v0.6.4,avg_memory_mb_consul_v0.6.4
0,106.663737,5038,5038,1.45,16.43
1,92.485359,10810,15848,31.79,55.47
2,106.769004,9088,24936,56.97,70.42
3,102.239278,10111,35047,77.35,92.26
4,113.725913,8538,43585,92.52,97.51
5,111.715838,9166,52751,105.44,117.02
6,110.618780,8929,61680,116.48,136.13
7,108.200289,9328,71008,126.14,127.34
8,115.940341,8531,79539,134.73,149.24
9,106.609103,9227,88766,140.65,166.70
10,103.627022,9810,98576,147.98,190.32
11,103.732476,9223,107799,153.98,208.33
12,101.709552,10283,118082,159.27,229.99
13,109.291794,8968,127050,164.28,250.53
14,105.182899,9217,136267,169.11,216.45
15,107.960788,9780,146047,172.17,233.51
16,106.765740,9313,155360,175.98,257.75
17,109.032520,9216,164576,178.64,273.72
18,114.956816,8315,172891,181.70,295.48
19,112.311044,9260,182151,183.70,312.26
20,106.400732,9437,191588,186.15,330.56
21,106.750672,9207,200795,188.46,352.14
22,102.240056,9884,210679,190.70,375.48
23,108.758118,9314,219993,193.10,395.62
24,101.743561,9711,229704,195.16,414.35
25,109.970456,8896,238600,196.79,436.65
26,114.999552,8743,247343,197.35,456.44
27,122.804138,8121,255464,197.91,473.31
28,127.595985,7939,263403,199.06,417.76
29,120.354180,8334,271737,199.97,404.38
30,108.891439,8800,280537,201.38,420.32
31,112.753816,9088,289625,202.04,442.12
32,131.161781,7554,297179,202.60,454.42
33,131.403858,7614,304793,203.21,471.64
34,113.642181,9024,313817,203.77,492.29
35,129.092563,7697,321514,204.35,503.48
36,112.128343,8983,330497,205.31,519.89
37,100.783185,9879,340376,205.89,542.64
38,114.996035,8716,349092,206.88,557.63
39,103.393768,8833,357925,208.10,573.53
40,113.430320,9665,367590,208.34,597.76
41,114.313415,8750,376340,209.32,613.63
42,94.275064,10575,386915,210.81,634.37
43,114.765252,8643,395558,211.21,650.24
44,94.566450,9264,404822,212.09,667.34
45,118.953724,9555,414377,213.02,694.69
46,109.934814,8859,423236,213.50,698.12
47,104.540817,9773,433009,214.49,729.91
48,113.321035,8661,441670,214.69,744.07
49,92.796170,10895,452565,216.01,766.39
50,119.831618,8339,460904,216.39,778.40
51,92.227487,10822,471726,217.56,802.41
52,131.678251,7614,479340,217.64,815.61
53,92.836327,10782,490122,218.60,840.08
54,135.298864,7422,497544,218.93,855.62
55,91.058015,10910,508454,219.95,879.66
56,115.930741,7826,516280,220.52,896.03
57,250.561522,3875,520155,219.92,697.25
58,446.529747,2071,522226,218.23,702.68
59,496.979354,2006,524232,215.91,705.60
60,344.109625,3404,527636,213.94,720.00
61,132.788358,7366,535002,213.55,736.23
62,191.290285,5306,540308,213.34,751.80
63,158.405801,6565,546873,212.32,758.23
64,120.075518,8227,555100,212.51,769.57
65,124.908976,7906,563006,212.89,780.13
66,126.032010,7940,570946,212.92,790.95
67,98.755628,10345,581291,213.78,814.04
68,126.248275,7900,589191,213.96,829.26
69,96.226844,10529,599720,214.89,854.95
70,114.214905,8552,608272,215.24,867.15
71,101.839056,9920,618192,215.42,880.42
72,100.945400,9767,627959,216.28,903.48
73,122.906894,8251,636210,216.52,918.59
74,98.696821,10149,646359,216.93,947.59
75,121.143901,8203,654562,217.52,966.30
76,90.883522,11153,665715,217.85,971.45
77,109.585364,9025,674740,218.73,999.59
78,123.864145,8076,682816,218.89,1018.26
79,94.573194,10181,692997,219.01,1024.77
80,109.425576,9465,702462,219.90,1055.66
81,118.011399,8517,710979,220.04,1072.43
82,91.955062,10478,721457,220.12,1080.46
83,126.815366,7138,728595,220.97,1117.23
84,113.860856,9915,738510,221.12,1125.58
85,106.306312,9243,747753,221.03,1129.55
86,125.208893,6920,754673,221.62,1168.64
87,141.845141,8043,762716,221.64,1179.40
88,111.866418,8795,771511,221.20,1182.91
89,117.992409,8265,779776,220.88,1194.67
90,143.372462,7239,787015,221.98,1235.41
91,114.820835,8754,795769,221.67,1239.85
92,110.980122,8937,804706,221.41,1243.99
93,150.971321,6440,811146,221.35,1273.70
94,118.897286,8613,819759,222.16,1299.49
95,99.938649,10188,829947,221.90,1303.37
96,126.445271,7902,837849,222.00,1324.14
97,103.238303,9777,847626,222.53,1358.65
98,91.136496,10893,858519,223.02,1366.87
99,103.218027,8099,866618,222.96,1382.20
100,123.859166,9355,875973,223.11,1392.94
101,111.122985,9041,885014,223.94,1428.31
102,99.110647,10113,895127,223.92,1433.00
103,133.305100,7522,902649,224.01,1454.88
104,88.117162,10709,913358,224.11,1472.31
105,124.875295,8382,921740,224.86,1498.61
106,98.677406,8039,929779,224.96,1519.30
107,123.449474,9755,939534,225.07,1525.56
108,99.517109,9147,948681,225.23,1557.93
109,113.990703,9572,958253,225.78,1571.95
110,137.697279,7163,965416,225.97,1595.25
111,98.372732,10240,975656,225.94,1597.93
112,119.873165,8316,983972,226.10,1623.99
113,99.782490,10073,994045,226.61,1644.30
114,146.063692,6803,1000848,226.72,1664.54
115,95.903934,10532,1011380,226.81,1670.96
116,175.586068,5211,1016591,226.23,1678.69
117,348.779226,2297,1018888,225.49,1700.63
118,491.362722,2075,1020963,224.41,1716.35
119,475.947929,2144,1023107,223.73,1724.86
120,404.018148,2478,1025585,222.56,1740.57
121,143.488694,8619,1034204,222.73,1744.50
122,98.064086,10293,1044497,222.86,1308.30
123,109.354265,8267,1052764,223.40,1356.59
124,192.995463,5433,1058197,223.78,1365.55
125,183.398072,5719,1063916,223.97,1375.73
126,97.109559,10272,1074188,224.45,1380.77
127,136.578498,6981,1081169,225.40,1428.18
128,163.281995,6180,1087349,225.34,1434.47
129,161.255043,6206,1093555,225.17,1439.97
130,180.002737,5691,1099246,225.44,1663.03
131,159.877799,6048,1105294,226.23,1848.98
132,173.948911,579,1105873,225.35,2272.99
133,1907.455084,333,1106206,224.17,2440.66
134,2103.309016,771,1106977,223.84,2574.85
135,1123.888322,965,1107942,223.21,2613.46
136,1283.094070,701,1108643,222.68,2652.84
137,1552.135819,532,1109175,222.15,2653.01
138,1656.267822,662,1109837,221.68,2653.01
139,1655.948828,732,1110569,221.05,2653.33
140,1689.667094,454,1111023,220.26,2655.82
141,1780.699660,103,1111126,218.87,2655.82
142,2566.663609,58,1111184,217.47,2655.82
143,3901.343674,74,1111258,216.54,2655.82
144,4448.664789,312,1111570,215.55,2655.82
145,5159.187114,76,1111646,214.28,2655.82
146,5869.604119,44,1111690,212.95,2655.82
147,6795.600039,42,1111732,211.63,2655.82
148,7736.811341,199,1111931,210.33,2655.82
149,8769.922233,15,1111946,209.04,2655.82
150,9759.575095,53,1111999,207.77,2655.82
151,10502.654298,55,1112054,206.76,2655.82
152,11152.563187,69,1112123,205.77,2655.82
153,11185.734649,58,1112181,205.22,2655.82
154,11152.041060,21,1112202,204.00,2656.00
155,0.000000,0,1112202,202.76,2656.00
156,13135.243482,1,1112203,201.57,2656.00
157,0.000000,0,1112203,200.37,2656.00
158,0.000000,0,1112203,199.11,2656.00
159,15831.829110,1,1112204,198.06,2656.00
160,0.000000,0,1112204,196.88,2656.00
161,0.000000,0,1112204,195.60,2656.00
162,19154.855941,3,1112207,194.45,2656.00
163,0.000000,0,1112207,193.32,2656.00
164,20806.729502,21,1112228,192.23,2656.00
165,0.000000,0,1112228,191.15,2656.30
166,0.000000,0,1112228,190.06,2656.30
167,23798.691142,1,1112229,188.98,2656.30
168,0.000000,0,1112229,187.90,2656.30
169,25146.893600,328,1112557,186.88,2656.85
170,25142.568970,86,1112643,185.90,2656.85
171,25186.958507,45,1112688,184.89,2656.85
172,25163.023320,42,1112730,183.90,2656.85
173,25139.358311,190,1112920,183.15,2656.85
174,25113.487110,25,1112945,182.56,2656.85
175,25070.942245,33,1112978,181.77,2656.85
176,25127.723111,53,1113031,181.00,2656.85
177,25109.073236,68,1113099,180.51,2661.02
178,25090.928814,81,1113180,179.75,2685.86
179,23961.947673,27,1113207,179.00,2711.35
180,11339.872650,350,1113557,178.62,2718.66
181,11073.804769,85,1113642,177.91,2718.66
182,11074.280274,1,1113643,177.18,2747.23
183,11960.887711,86,1113729,176.77,3077.17
184,11077.869595,189,1113918,176.04,3096.28
185,11081.093536,26,1113944,175.52,3137.67
186,11083.502533,33,1113977,174.65,3171.51
187,11082.278902,53,1114030,174.13,3180.97
188,11082.572234,68,1114098,173.28,3180.97
189,11084.862759,80,1114178,172.44,3181.05
190,11015.552829,29,1114207,171.59,3181.05
191,11007.700334,345,1114552,170.77,3200.45
192,11013.365960,90,1114642,170.32,3250.59
193,9344.441189,256,1114898,169.83,3259.80
194,9318.109438,39,1114937,169.48,3259.80
195,9320.045516,27,1114964,168.78,3259.80
196,9324.827330,61,1115025,167.98,3259.80
197,9328.139355,69,1115094,167.20,3259.88
198,9332.021833,64,1115158,166.57,3259.88
199,9345.243511,41,1115199,165.95,3259.88
200,9398.584892,243,1115442,165.19,3259.88
201,9399.749447,190,1115632,164.46,3259.88
202,9489.039175,98,1115730,164.01,3259.88
203,9745.284032,176,1115906,163.59,3259.88
204,10063.512056,30,1115936,163.15,3259.88
205,10098.140687,15,1115951,162.42,3259.88
206,10098.564482,73,1116024,161.69,3259.88
207,10099.024590,44,1116068,160.97,3259.88
208,10120.535402,89,1116157,160.26,3259.88
209,10184.229422,24,1116181,159.56,3259.88
210,10146.744338,185,1116366,159.11,3259.88
211,10116.908657,255,1116621,158.86,3259.88
212,10134.601846,29,1116650,158.42,3259.88
213,10431.061680,148,1116798,157.74,3259.88
214,10719.945133,118,1116916,157.06,3259.88
215,10758.926475,24,1116940,156.39,3259.88
216,10751.743325,34,1116974,156.03,3259.88
217,10752.325203,53,1117027,155.37,3259.88
218,10751.637855,69,1117096,154.71,3260.06
219,10723.488189,82,1117178,154.22,3260.06
220,9830.399993,297,1117475,153.95,3260.06
221,9843.511538,157,1117632,153.54,3260.06
222,9818.309174,78,1117710,153.03,3260.06
223,9931.473129,88,1117798,152.40,3260.06
224,9986.521875,118,1117916,151.77,3260.06
225,9979.076714,24,1117940,151.16,3260.06
226,9974.819385,34,1117974,150.54,3260.06
227,9971.550809,54,1118028,150.18,3260.06
228,9971.323675,68,1118096,149.85,3260.06
229,9986.095557,63,1118159,149.55,3260.06
230,10400.063697,69,1118228,148.96,3260.06
231,10567.108928,330,1118558,148.38,3260.06
232,10565.797853,86,1118644,147.82,3260.06
233,10577.136088,88,1118732,147.51,3260.06
234,10732.719916,114,1118846,146.94,3260.06
235,10712.922612,85,1118931,146.37,3260.06
236,10722.873655,15,1118946,145.81,3260.06
237,10731.522115,35,1118981,145.50,3260.06
238,10768.039879,50,1119031,145.20,3260.06
239,10725.038077,68,1119099,144.65,3260.06
240,10711.740718,62,1119161,144.09,3260.06
241,10989.189806,46,1119207,143.80,3260.06
242,11024.263259,321,1119528,143.28,3260.06
243,11067.554404,115,1119643,142.75,3260.06
244,11155.007598,87,1119730,142.22,3260.06
245,11114.341693,70,1119800,141.69,3260.06
246,11062.395988,120,1119920,141.41,3260.06
247,10990.420004,25,1119945,141.11,3260.06
248,10940.986520,37,1119982,140.59,3260.06
249,10846.342945,82,1120064,140.06,3260.06
250,10709.079474,88,1120152,139.79,3260.06
251,10628.062676,31,1120183,139.28,3260.06
252,10555.237699,241,1120424,138.77,3260.06
253,10506.506213,208,1120632,138.28,3260.06
254,10361.562282,77,1120709,137.78,3260.06
255,10379.851797,32,1120741,137.53,3260.06
256,10303.644993,177,1120918,137.28,3260.06
257,10171.878930,27,1120945,136.79,3260.06
258,10071.465053,38,1120983,136.30,3260.06
259,9981.950771,81,1121064,136.06,3260.06
260,9950.642082,92,1121156,135.58,3260.06
261,9812.465270,33,1121189,135.10,3260.06
262,9801.025289,254,1121443,134.63,3260.06
263,9747.769419,199,1121642,134.25,3260.06
264,9623.072878,90,1121732,134.07,3260.06
265,9513.030648,116,1121848,133.73,3260.06
266,9475.061743,86,1121934,133.27,3260.06
267,9334.659629,41,1121975,132.82,3260.06
268,9332.934200,55,1122030,132.60,3260.06
269,9213.132078,97,1122127,132.14,3260.06
270,9197.186220,56,1122183,131.70,3260.06
271,9074.393090,237,1122420,131.26,3260.06
272,9222.977721,214,1122634,131.00,3260.06
273,9102.258844,81,1122715,130.84,3260.06
274,8974.145528,132,1122847,130.42,3260.06
275,8916.235119,89,1122936,130.00,3260.06
276,8821.312202,44,1122980,129.56,3260.06
277,8797.932605,84,1123064,129.38,3260.06
278,8742.665024,94,1123158,128.96,3260.06
279,8573.623297,70,1123228,128.53,3260.06
280,8531.408222,301,1123529,128.12,3260.06
281,8488.445749,122,1123651,127.92,3260.06
282,8382.391713,148,1123799,127.75,3260.06
283,8276.313288,134,1123933,127.34,3260.06
284,8140.379653,46,1123979,126.93,3260.06
285,8086.283567,85,1124064,126.52,3260.06
286,8069.661410,97,1124161,126.34,3260.06
287,7972.968979,67,1124228,125.93,3260.06
288,7881.847050,365,1124593,125.54,3260.06
289,7775.724850,117,1124710,125.15,3260.06
290,7711.522638,138,1124848,124.97,3260.06
291,7691.957951,95,1124943,124.83,3260.06
292,7515.954110,86,1125029,124.44,3260.06
293,7406.350643,72,1125101,124.05,3260.06
294,7417.557939,85,1125186,123.67,3260.06
295,7272.213000,323,1125509,123.51,3260.06
296,7196.187815,201,1125710,123.21,3260.06
297,7217.103345,91,1125801,123.13,3260.06
298,7085.648100,142,1125943,122.90,3260.06
299,6982.575246,86,1126029,122.63,3260.11
300,6897.861038,100,1126129,122.58,3260.11
301,6740.332715,100,1126229,122.31,3260.11
302,6767.929844,366,1126595,122.29,3260.11
303,6787.952860,122,1126717,122.03,3261.25
304,6650.674789,194,1126911,121.79,3261.25
305,6653.731699,43,1126954,121.44,3261.25
306,6557.370093,114,1127068,121.07,3261.25
307,6486.770184,116,1127184,120.71,3261.25
308,6449.719988,239,1127423,120.42,3261.25
309,6508.528351,226,1127649,120.22,3261.25
310,6400.482569,217,1127866,120.07,3261.34
311,6341.926573,82,1127948,119.72,3261.34
312,6266.512187,117,1128065,119.56,3261.34
313,6173.738067,113,1128178,119.23,3261.34
314,6109.416572,244,1128422,118.88,3261.34
315,6157.885621,226,1128648,118.55,3261.34
316,6047.373762,156,1128804,118.21,3261.34
317,6012.440028,145,1128949,118.03,3261.34
318,5881.659463,120,1129069,117.73,3261.34
319,5847.728612,117,1129186,117.58,3261.34
320,5736.101246,270,1129456,117.26,3261.34
321,5730.937869,255,1129711,117.14,3261.42
322,5617.202457,199,1129910,116.81,3261.42
323,5560.303806,72,1129982,116.49,3261.42
324,5536.552746,127,1130109,116.16,3261.42
325,5400.735097,249,1130358,115.85,3261.42
326,5379.826896,290,1130648,115.72,3261.42
327,5234.469766,219,1130867,115.43,3261.42
328,5167.275290,115,1130982,115.28,3261.42
329,5120.427081,128,1131110,114.96,3261.42
330,5095.887331,249,1131359,114.85,3261.42
331,5138.169005,240,1131599,114.56,3261.42
332,5098.399656,270,1131869,114.36,3261.42
333,5054.454816,89,1131958,114.16,3261.42
334,4918.009550,206,1132164,113.94,3261.42
335,4898.251550,196,1132360,114.09,3261.42
336,4829.257722,290,1132650,113.90,3261.42
337,4743.855720,262,1132912,113.68,3261.42
338,4674.806972,99,1133011,113.40,3261.42
339,4660.377678,220,1133231,113.10,3261.42
340,4521.259090,260,1133491,112.81,3261.42
341,4640.861456,227,1133718,112.68,3261.42
342,4541.760473,238,1133956,112.80,3261.42
343,4340.039892,210,1134166,112.59,3261.42
344,4243.530096,260,1134426,112.39,3261.42
345,4277.334565,287,1134713,112.20,3261.42
346,4341.008005,225,1134938,112.06,3261.42
347,4314.268601,135,1135073,111.95,3263.47
348,4346.808401,227,1135300,111.66,3263.47
349,4389.577133,257,1135557,111.38,3263.47
350,4276.276790,313,1135870,111.18,3263.47
351,4248.172429,198,1136068,111.07,3263.47
352,4221.833499,168,1136236,110.90,3263.47
353,4229.170376,321,1136557,110.63,3263.47
354,4290.216313,228,1136785,110.36,3263.47
355,4305.784565,200,1136985,110.27,3263.47
356,4291.136284,204,1137189,110.00,3263.47
357,4260.347830,239,1137428,109.73,3263.47
358,4231.221810,287,1137715,109.47,3263.47
359,4327.971296,242,1137957,109.36,3263.47
360,4320.015456,157,1138114,109.28,3263.47
361,4316.962055,250,1138364,109.01,3263.47
362,4375.875912,289,1138653,108.75,3263.47
363,4342.566406,219,1138872,108.58,3263.47
364,4405.638432,196,1139068,108.39,3263.47
365,4470.801958,47,1139115,108.12,3263.47
366,4978.384251,250,1139365,107.86,3263.47
367,0.000000,0,1139365,107.58,3263.47
368,0.000000,0,1139365,107.31,3263.47
369,6158.053860,709,1140074,107.21,3263.47
370,0.000000,0,1140074,106.96,3263.47
371,0.000000,0,1140074,106.70,3263.47
372,0.000000,0,1140074,106.52,3263.47
373,0.000000,0,1140074,106.29,3263.47
374,0.000000,0,1140074,106.02,3263.47
375,0.000000,0,1140074,105.76,3263.47
376,0.000000,0,1140074,105.48,3263.47
377,10997.435801,198,1140272,105.21,3263.47
378,0.000000,0,1140272,104.93,3263.47
379,0.000000,0,1140272,104.64,3263.47
380,14181.186538,65,1140337,104.38,3263.47
381,12337.187852,257,1140594,104.11,3263.47
382,8776.798249,846,1141440,103.89,3263.47
383,1395.410186,651,1142091,103.97,3263.47
384,1424.255108,780,1142871,103.72,3263.47
385,1436.407716,390,1143261,103.50,3263.47
386,1462.263944,974,1144235,103.28,3263.47
387,1351.352372,715,1144950,103.23,3263.47
388,1458.948238,650,1145600,103.20,3263.47
389,1471.177626,643,1146243,102.99,3263.47
390,1908.672718,394,1146637,102.77,3263.47
391,2349.229824,392,1147029,102.55,3263.47
392,2523.251912,326,1147355,102.50,3263.47
393,2429.936642,454,1147809,102.29,3263.47
394,2648.239989,285,1148094,102.06,3263.47
395,2695.172300,327,1148421,102.00,3263.47
396,2832.669544,453,1148874,101.95,3263.47
397,2841.960607,221,1149095,101.73,3263.47
398,3004.178836,325,1149420,101.51,3263.47
399,3039.181877,390,1149810,101.29,3263.47
400,3092.676552,284,1150094,101.23,3263.47
401,3073.440788,327,1150421,101.03,3263.47
402,3041.193287,328,1150749,100.81,3263.47
403,3212.169735,322,1151071,100.74,3263.47
404,3272.123750,284,1151355,100.53,3263.47
405,3323.198136,263,1151618,100.47,3263.47
406,3409.268139,292,1151910,100.25,3263.47
407,3515.677640,253,1152163,100.04,3263.47
408,3563.808100,310,1152473,99.82,3263.47
409,3573.116753,275,1152748,99.77,3263.47
410,3671.886177,258,1153006,99.57,3263.47
411,3648.137118,227,1153233,99.36,3263.47
412,3715.099009,319,1153552,99.31,3263.47
413,3719.944355,261,1153813,99.21,3263.47
414,3771.354548,259,1154072,99.07,3263.47
415,3735.406439,226,1154298,98.90,3263.47
416,3848.139002,322,1154620,98.72,3263.47
417,3847.249886,195,1154815,98.53,3263.47
418,3890.241451,283,1155098,98.48,3263.47
419,3837.205219,265,1155363,98.29,3263.47
420,3809.182908,257,1155620,98.08,3263.47
421,3838.234117,260,1155880,98.03,3263.47
422,3958.051791,220,1156100,97.84,3263.47
423,4072.751436,199,1156299,97.78,3263.47
424,4095.246508,320,1156619,97.58,3263.47
425,4045.371384,197,1156816,97.38,3263.47
426,4056.296468,281,1157097,97.18,3263.47
427,4073.440325,202,1157299,97.14,3263.47
428,4073.848847,321,1157620,96.94,3263.47
429,4067.347113,196,1157816,96.75,3263.47
430,4092.018323,257,1158073,96.70,3263.47
431,4107.359016,226,1158299,96.50,3263.47
432,4043.000284,256,1158555,96.46,3263.47
433,4154.577917,260,1158815,96.26,3263.47
434,4169.871329,195,1159010,96.08,3263.47
435,4189.588000,224,1159234,95.88,3263.47
436,4173.839030,319,1159553,95.83,3263.47
437,4207.419901,201,1159754,95.65,3263.47
438,4222.640966,196,1159950,95.46,3263.47
439,4188.987156,284,1160234,95.41,3263.47
440,4060.915566,319,1160553,95.22,3263.47
441,4121.514314,197,1160750,95.17,3263.47
442,4049.171694,200,1160950,94.99,3263.47
443,4053.077445,222,1161172,94.80,3263.47
444,4172.189407,258,1161430,94.61,3172.39
445,4198.794093,258,1161688,94.58,3172.39
446,4182.518006,199,1161887,94.40,3172.39
447,4137.386832,285,1162172,94.21,3172.39
448,4067.039771,258,1162430,94.17,3172.39
449,4135.220623,256,1162686,94.00,3172.39
450,4189.291777,198,1162884,93.95,3172.39
451,4134.326469,223,1163107,93.77,3172.39
452,4192.169468,260,1163367,93.59,3172.39
453,4167.029108,236,1163603,93.42,3172.39
454,4270.949354,217,1163820,93.39,3172.39
455,4213.720091,255,1164075,93.21,3172.39
456,4222.018535,227,1164302,93.06,3172.39
457,4170.349811,254,1164556,93.01,3172.39
458,4142.007527,264,1164820,92.84,3172.39
459,4099.015645,254,1165074,92.80,3172.39
460,4100.067973,221,1165295,92.62,3172.39
461,4122.092122,261,1165556,92.45,3172.39
462,4106.191646,225,1165781,92.28,3172.39
463,4124.037897,293,1166074,92.25,3172.39
464,4149.880831,164,1166238,92.08,3172.39
465,4170.580524,317,1166555,91.97,3172.39
466,4119.119566,137,1166692,91.89,3172.39
467,4235.511619,261,1166953,91.81,3172.39
468,4238.382688,283,1167236,91.70,3172.39
469,4234.425562,254,1167490,91.52,3172.39
470,4179.102640,202,1167692,91.36,3172.39
471,4124.161474,200,1167892,91.19,3172.39
472,4147.954026,218,1168110,91.16,3172.39
473,4174.383842,322,1168432,91.00,3172.39
474,4188.565272,229,1168661,90.92,3172.39
475,4154.414733,226,1168887,90.81,3172.39
476,4147.762789,219,1169106,90.77,3172.39
477,4266.272916,263,1169369,90.63,3172.39
478,4260.286142,228,1169597,90.46,3172.39
479,4263.414220,228,1169825,90.31,3172.39
480,4204.134431,196,1170021,90.15,3172.39
481,4314.461453,220,1170241,90.12,3172.39
482,4297.761178,317,1170558,89.97,3172.39
483,4283.720306,265,1170823,89.87,3172.39
484,4219.117966,197,1171020,89.79,3172.39
485,4228.053491,157,1171177,89.75,3172.39
486,4239.433766,317,1171494,89.60,3172.39
487,4245.619578,204,1171698,89.48,3172.39
488,4285.419153,195,1171893,89.39,3172.39
489,4313.676336,219,1172112,89.30,3172.39
490,4339.707769,260,1172372,89.32,3172.39
491,4302.716515,229,1172601,89.40,3172.39
492,4284.277687,288,1172889,89.38,3172.39
493,4287.922557,192,1173081,89.34,3172.39
494,4166.741380,283,1173364,89.19,3172.39
495,4319.111404,203,1173567,89.03,3172.39
496,4271.688624,263,1173830,88.88,3172.39
497,4348.531516,191,1174021,88.86,3172.39
498,4310.905503,212,1174233,88.70,3172.39
499,4376.209408,261,1174494,88.65,3172.39
500,4373.948038,204,1174698,88.53,3172.39
501,4397.852649,198,1174896,88.43,3172.39
502,4385.869513,221,1175117,88.35,3172.39
503,4399.172074,256,1175373,88.20,3172.39
504,4368.577703,292,1175665,88.05,3172.39
505,4338.852389,169,1175834,87.90,3172.39
506,4378.192933,277,1176111,87.88,3175.66
507,4288.487368,189,1176300,87.73,3175.66
508,4392.482714,262,1176562,87.59,3175.66
509,4405.049790,264,1176826,87.57,3175.66
510,4434.598910,136,1176962,87.44,3175.66
511,4371.769870,272,1177234,87.39,3175.66
512,4374.824422,205,1177439,87.24,3175.66
513,4394.609617,260,1177699,87.10,3175.66
514,4398.227684,193,1177892,86.96,3175.66
515,4390.386982,224,1178116,86.93,3175.66
516,4427.235648,250,1178366,86.79,3175.66
517,4378.798352,203,1178569,86.75,3175.66
518,4502.863222,199,1178768,86.70,3175.92
519,4615.772217,159,1178927,86.62,3175.92
520,4670.494636,308,1179235,86.65,3175.92
521,4594.351305,206,1179441,86.57,3175.92
522,4638.676638,224,1179665,86.60,3175.92
523,4585.156707,225,1179890,86.53,3175.92
524,4591.505193,139,1180029,86.41,3175.92
525,4752.008167,209,1180238,86.27,3175.92
526,4743.161170,260,1180498,86.12,3175.92
527,4742.053923,204,1180702,85.97,3175.92
528,4860.313490,191,1180893,85.83,3175.92
529,4664.747579,226,1181119,85.84,3175.92
530,4631.105219,251,1181370,85.80,3175.92
531,4522.455376,204,1181574,85.63,3175.92
532,4444.420023,262,1181836,85.48,3175.92
533,4382.087164,220,1182056,85.34,3175.92
534,4364.049255,247,1182303,85.20,3175.92
535,4265.194561,260,1182563,85.06,3175.92
536,4208.948094,207,1182770,84.93,3175.92
537,4233.407549,190,1182960,84.79,3175.92
538,4274.317968,224,1183184,84.78,3175.92
539,4317.149511,258,1183442,84.90,3176.42
540,4357.492796,257,1183699,84.76,3176.42
541,4392.588085,195,1183894,84.65,3176.42
542,4405.891975,205,1184099,84.58,3176.42
543,4331.706961,334,1184433,84.51,3176.42
544,4420.361621,197,1184630,84.55,3176.42
545,4321.787609,208,1184838,84.48,3176.42
546,4296.600080,220,1185058,84.41,3176.42
547,4217.808740,311,1185369,84.34,3176.42
548,4247.363109,195,1185564,84.46,3176.50
549,4295.349756,204,1185768,84.36,3176.50
550,4685.025687,193,1185961,84.32,3176.50
551,0.000000,0,1185961,84.20,3176.50
552,0.000000,0,1185961,84.08,3176.50
553,0.000000,0,1185961,83.94,3176.50
554,0.000000,0,1185961,83.80,3176.50
555,0.000000,0,1185961,83.67,3176.50
556,8049.898184,910,1186871,83.55,3176.50
557,0.000000,0,1186871,83.41,3176.50
558,0.000000,0,1186871,83.38,3176.50
559,0.000000,0,1186871,83.24,3176.50
560,0.000000,0,1186871,83.10,3176.50
561,0.000000,0,1186871,82.95,3176.50
562,0.000000,0,1186871,82.81,3176.50
563,0.000000,0,1186871,82.67,3176.50
564,12347.689285,131,1187002,82.52,3176.50
565,0.000000,0,1187002,82.41,3176.50
566,10133.483339,260,1187262,82.30,3176.50
567,10732.939941,585,1187847,82.18,3176.50
568,1952.081238,908,1188755,82.12,3176.50
569,1335.938216,521,1189276,82.08,3176.50
570,1489.961501,865,1190141,82.00,3176.50
571,1501.582205,630,1190771,82.02,3176.50
572,1409.953111,715,1191486,81.91,3176.50
573,1354.254868,780,1192266,81.92,3176.50
574,1423.643837,454,1192720,81.82,3176.50
575,1438.064904,714,1193434,81.71,3176.50
576,1681.795629,520,1193954,81.71,3176.51
577,2263.923243,455,1194409,81.59,3176.51
578,2298.549794,391,1194800,81.47,3176.51
579,2242.358393,455,1195255,81.35,3176.51
580,2315.999834,351,1195606,81.23,3176.51
581,2524.839679,452,1196058,81.11,3176.51
582,2555.692725,264,1196322,81.10,3176.51
583,2779.110643,413,1196735,80.98,3176.51
584,2803.862517,388,1197123,80.98,3176.51
585,2847.603341,201,1197324,80.98,3176.51
586,3081.736344,348,1197672,80.86,3176.51
587,3103.883513,323,1197995,80.75,3176.51
588,3303.205131,326,1198321,80.63,3176.51
589,3321.624151,221,1198542,80.51,3176.51
590,3351.912577,388,1198930,80.40,3176.51
591,3299.707266,325,1199255,80.40,3176.51
592,3324.555529,260,1199515,80.29,3176.51
593,3280.295316,293,1199808,80.29,3151.18
594,3304.774744,316,1200124,80.29,3149.27
595,3285.149917,201,1200325,80.18,3149.27
596,3280.650938,411,1200736,80.07,3149.27
597,3269.932943,324,1201060,79.96,3149.45
598,3289.488880,262,1201322,79.85,3149.45
599,3347.691706,284,1201606,79.74,3149.45
600,3413.575955,264,1201870,79.63,3149.45
601,3486.306502,383,1202253,79.68,3149.45
602,3570.626673,138,1202391,79.63,3149.45
603,3579.074177,347,1202738,79.62,3149.45
604,3605.516448,261,1202999,79.51,3149.45
605,3615.300497,260,1203259,79.40,3149.45
606,3642.453662,258,1203517,79.29,3149.45
607,3625.739889,350,1203867,79.18,3149.45
608,3579.986876,252,1204119,79.07,3149.45
609,3630.761673,207,1204326,78.96,3149.45
610,3614.374910,322,1204648,78.96,3149.45
611,3668.481036,287,1204935,78.96,3150.76
612,3647.287264,322,1205257,78.95,3150.76
613,3638.484583,136,1205393,78.84,3150.76
614,3623.096165,286,1205679,78.73,3150.76
615,3615.518644,389,1206068,78.63,3150.76
616,3654.681572,196,1206264,78.52,3150.76
617,3642.051997,254,1206518,78.41,3150.76
618,3694.551443,291,1206809,78.30,3150.76
619,3802.136023,310,1207119,78.31,3150.85
620,3752.866270,210,1207329,78.30,3150.85
621,3724.449402,255,1207584,78.28,3154.18
622,3755.546517,288,1207872,78.19,3154.18
623,3812.415130,316,1208188,78.09,3154.18
624,3783.846625,203,1208391,77.98,3154.18
625,3790.192691,287,1208678,77.87,3154.18
626,3927.051143,197,1208875,77.77,3154.18
627,3954.419639,313,1209188,77.66,3154.18
628,3963.476545,204,1209392,77.64,3154.18
629,3954.126771,261,1209653,77.67,3155.99
630,4006.008989,222,1209875,77.59,3155.99
631,3906.878993,378,1210253,77.57,3156.60
632,3858.679281,200,1210453,77.47,3156.60
633,3863.707577,226,1210679,77.37,3156.60
634,3909.688013,262,1210941,77.27,3156.60
635,3871.808761,318,1211259,77.17,3156.60
636,3863.209548,199,1211458,77.06,3156.60
637,3900.089828,239,1211697,76.96,3156.60
638,3855.337176,306,1212003,77.07,3156.60
639,3891.669540,256,1212259,76.97,3156.60
640,3836.859777,264,1212523,76.97,3156.60
641,3884.995617,177,1212700,76.87,3156.60
642,3967.153681,308,1213008,76.77,3156.60
643,4006.106145,251,1213259,76.67,3156.60
644,3924.909631,200,1213459,76.57,3156.60
645,3998.406141,242,1213701,76.47,3156.60
646,3948.640633,309,1214010,76.37,3156.60
647,3944.835126,250,1214260,76.43,3156.60
648,4073.434792,200,1214460,76.38,3158.07
649,4017.209793,240,1214700,76.39,3160.38
650,4030.067743,310,1215010,76.29,3160.38
651,4104.231920,249,1215259,76.19,3160.38
652,4154.105860,144,1215403,76.09,3160.38
653,4224.224266,294,1215697,75.99,3160.38
654,4200.812899,246,1215943,75.90,3160.38
655,4224.144810,250,1216193,75.80,3160.38
656,4268.093849,203,1216396,75.76,3160.38
657,4291.536431,257,1216653,75.82,3160.38
658,4322.528828,165,1216818,75.82,3160.38
659,4292.521320,263,1217081,75.73,3160.38
660,4283.774837,245,1217326,75.64,3160.38
661,4315.079199,260,1217586,75.57,3160.38
662,4280.424744,182,1217768,75.52,3160.38
663,4340.037201,246,1218014,75.48,3160.38
664,4370.743046,245,1218259,75.52,3160.38
665,4405.215987,146,1218405,75.49,3160.38
666,4372.913384,252,1218657,75.64,3164.45
667,4393.639626,251,1218908,75.60,3164.45
668,4437.200762,237,1219145,75.51,3164.54
669,4481.599034,248,1219393,75.42,3164.54
670,4432.654440,213,1219606,75.41,3164.54
671,4470.747606,166,1219772,75.33,3164.54
672,4676.141826,240,1220012,75.24,3164.54
673,4621.446991,247,1220259,75.14,3164.78
674,4599.088509,146,1220405,75.04,3164.87
675,4708.778896,249,1220654,75.10,3164.87
676,4688.624417,166,1220820,75.06,3164.87
677,4716.976398,258,1221078,74.96,3164.87
678,4713.428207,248,1221326,74.86,3164.87
679,4719.881804,136,1221462,74.77,3164.87
680,4790.796129,241,1221703,74.78,3172.19
681,4831.469341,145,1221848,74.68,3172.19
682,4816.554603,233,1222081,74.59,3172.19
683,4838.354247,251,1222332,74.50,3172.19
684,4877.487084,130,1222462,74.40,3172.19
685,4898.100373,242,1222704,74.50,3173.49
686,4925.286703,204,1222908,74.41,3173.49
687,4886.526405,238,1223146,74.32,3173.49
688,4911.341869,186,1223332,74.22,3173.49
689,4962.988707,130,1223462,74.23,3173.49
690,4993.525569,243,1223705,74.15,3173.49
691,4949.382713,183,1223888,74.05,3173.49
692,5102.138062,195,1224083,73.97,3173.49
693,5070.160635,251,1224334,73.87,3173.49
694,5159.949210,74,1224408,73.96,3174.85
695,5882.665366,3,1224411,73.88,3174.85
696,0.000000,0,1224411,73.79,3174.85
697,7461.062717,2,1224413,73.69,3174.85
698,0.000000,0,1224413,73.59,3174.85
699,9830.286281,173,1224586,73.49,3174.87
700,9820.471488,123,1224709,73.40,3174.87
701,9817.225908,238,1224947,73.31,3174.87
702,9806.393863,203,1225150,73.22,3174.87
703,9796.371551,198,1225348,73.11,3174.87
704,9621.639545,66,1225414,73.11,3174.87
705,5422.094475,244,1225658,73.03,3174.87
706,5519.751567,164,1225822,73.05,3183.99
707,5521.601424,257,1226079,72.97,3183.99
708,5559.579078,124,1226203,72.85,3183.99
709,5738.782968,147,1226350,72.80,3183.99
710,5969.723512,65,1226415,72.76,3183.99
711,6239.045232,193,1226608,72.75,3183.99
712,6526.041122,97,1226705,72.74,3183.99
713,6839.182153,118,1226823,72.70,3184.07
714,7066.813770,127,1226950,72.76,3184.16
715,7376.358775,139,1227089,72.81,3184.16
716,7806.382769,114,1227203,72.77,3201.58
717,8079.602745,146,1227349,72.85,3203.44
718,8120.310398,65,1227414,72.80,3203.44
719,7921.717742,237,1227651,72.76,3203.44
720,7095.641923,172,1227823,72.82,3203.44
721,6989.697539,129,1227952,72.78,3203.44
722,7024.099096,132,1228084,72.74,3203.44
723,7102.878914,114,1228198,72.70,3203.44
724,7102.384270,151,1228349,72.70,3203.44
725,7134.774113,64,1228413,72.62,3203.44
726,7182.367804,238,1228651,72.64,3211.29
727,7114.391396,127,1228778,72.64,3211.29
728,7166.134414,169,1228947,72.56,3211.29
729,7110.947042,137,1229084,72.47,3211.33
730,7171.714600,114,1229198,72.38,3211.33
731,7064.819527,139,1229337,72.30,3211.33
732,7116.654157,78,1229415,72.21,3211.33
733,6954.321959,175,1229590,72.15,3211.33
734,7120.576220,188,1229778,72.13,3211.33
735,7076.235395,133,1229911,72.05,3211.33
736,7106.909088,172,1230083,72.15,3213.47
737,7068.090079,116,1230199,72.06,3213.47
738,7018.558872,138,1230337,71.98,3213.47
739,7036.476225,78,1230415,71.89,3213.47
740,6972.181786,173,1230588,71.81,3213.47
741,7058.215098,187,1230775,71.73,3213.56
742,6965.205230,136,1230911,71.64,3212.91
743,6968.348222,172,1231083,71.64,3208.35
744,6953.405451,120,1231203,71.56,3208.35
745,6877.794137,147,1231350,71.47,3207.75
746,6883.506673,67,1231417,71.49,3207.75
747,6909.695005,177,1231594,71.41,3207.75
748,6901.505053,186,1231780,71.32,3207.75
749,6910.095862,132,1231912,71.24,3207.75
750,6963.770434,104,1232016,71.15,3207.75
751,0.000000,0,1232016,71.06,3207.75
752,8290.100676,305,1232321,70.98,3207.75
753,7467.576853,32,1232353,70.97,3207.75
754,0.000000,0,1232353,70.88,3207.75
755,7592.292590,421,1232774,70.80,3207.75
756,0.000000,0,1232774,70.72,3207.75
757,7370.984420,306,1233080,70.65,3207.75
758,0.000000,0,1233080,70.57,3207.75
759,0.000000,0,1233080,70.49,3207.75
760,7364.695638,65,1233145,70.40,3207.75
761,0.000000,0,1233145,70.31,3207.75
762,0.000000,0,1233145,70.30,3207.75
763,0.000000,0,1233145,70.21,3207.75
764,0.000000,0,1233145,70.13,3207.75
765,0.000000,0,1233145,70.05,3207.75
766,13665.337281,130,1233275,69.96,3207.75
767,13396.920570,195,1233470,69.87,3207.75
768,11028.588233,714,1234184,69.81,3207.75
769,1560.379609,714,1234898,69.75,3207.75
770,1462.184555,716,1235614,69.78,3207.75
771,1438.438511,715,1236329,69.87,3207.75
772,1418.766953,714,1237043,69.83,3207.75
773,1961.382021,262,1237305,69.76,3207.75
774,1447.984546,908,1238213,69.70,3207.75
775,1267.159292,780,1238993,69.73,3207.75
776,1482.155557,845,1239838,69.67,3207.75
777,1293.469903,388,1240226,69.61,3207.75
778,1544.529161,975,1241201,69.55,3208.18
779,1351.416121,584,1241785,69.49,3208.18
780,1765.794426,388,1242173,69.51,3208.18
781,2137.676071,392,1242565,69.61,3208.18
782,2556.746832,389,1242954,69.55,3208.18
783,2596.859205,454,1243408,69.47,3208.18
784,2568.676987,350,1243758,69.40,3208.18
785,2563.917644,326,1244084,69.33,3208.18
786,2668.381116,323,1244407,69.26,3208.18
787,2928.862304,288,1244695,69.19,3208.18
788,3102.366424,325,1245020,69.12,3208.18
789,3095.513647,387,1245407,69.07,3208.18
790,3133.129515,224,1245631,69.24,3208.18
791,3112.302908,389,1246020,69.17,3208.18
792,3145.363630,262,1246282,69.11,3208.18
793,3380.893593,261,1246543,69.03,3208.18
794,3294.797363,286,1246829,68.96,3208.18
795,3396.006504,385,1247214,68.89,3208.18
796,3429.018333,259,1247473,68.82,3208.18
797,3394.174544,351,1247824,68.75,3208.18
798,3357.002146,261,1248085,68.68,3208.18
799,3398.964134,234,1248319,68.79,3208.18
800,3409.787274,291,1248610,68.80,3208.18
801,3539.159962,220,1248830,68.74,3208.18
802,3586.321136,386,1249216,68.66,3208.18
803,3532.765400,281,1249497,68.59,3208.18
804,3469.981979,267,1249764,68.52,3208.18
805,3470.860444,261,1250025,68.46,3208.18
806,3655.247138,294,1250319,68.38,3208.18
807,3578.109808,292,1250611,68.32,3208.18
808,3569.225316,284,1250895,68.25,3208.18
809,3584.121855,256,1251151,68.44,3208.18
810,3624.370149,263,1251414,68.37,3208.18
811,3638.931833,221,1251635,68.30,3208.18
812,3785.856392,323,1251958,68.23,3208.18
813,3816.763121,196,1252154,68.17,3208.18
814,3838.958220,265,1252419,68.10,3208.18
815,3893.642717,281,1252700,68.03,3208.18
816,3838.527249,285,1252985,67.96,3208.18
817,3816.229134,230,1253215,67.89,3208.18
818,3818.990738,269,1253484,67.95,3208.18
819,3870.184733,283,1253767,68.02,3208.18
820,3896.561765,258,1254025,67.95,3208.18
821,3874.348013,259,1254284,67.88,3208.18
822,3854.821136,203,1254487,67.81,3208.18
823,3898.798512,281,1254768,67.75,3208.18
824,3893.603640,258,1255026,67.68,3208.18
825,3889.177677,258,1255284,67.62,3208.18
826,3887.242829,254,1255538,67.57,3208.18
827,3825.560729,291,1255829,67.50,3208.18
828,3862.765602,257,1256086,67.61,3208.18
829,3943.693410,235,1256321,67.61,3208.18
830,3906.591354,217,1256538,67.55,3208.18
831,4005.654352,291,1256829,67.48,3208.18
832,4015.268488,259,1257088,67.42,3208.18
833,3905.489014,234,1257322,67.35,3208.62
834,3887.560862,217,1257539,67.29,3208.62
835,3890.656090,298,1257837,67.22,3208.62
836,3837.534887,316,1258153,67.16,3208.62
837,3821.349860,203,1258356,67.17,3208.62
838,3765.671792,313,1258669,67.20,3208.62
839,3738.221808,234,1258903,67.22,3208.62
840,3712.187397,257,1259160,67.16,3208.62
841,3667.864216,326,1259486,67.10,3208.62
842,3665.113403,284,1259770,67.03,3208.62
843,3690.849076,197,1259967,66.99,3208.62
844,3725.035309,318,1260285,66.99,3208.62
845,3716.665891,254,1260539,67.09,3208.62
846,3739.397474,298,1260837,67.17,3208.62
847,3776.312213,253,1261090,67.23,3208.62
848,3852.419009,197,1261287,67.28,3208.62
849,3889.436619,316,1261603,67.30,3215.21
850,3860.869519,235,1261838,67.38,3240.88
851,3908.476270,254,1262092,67.43,3255.04
852,3980.120402,232,1262324,67.37,3255.04
853,3974.934262,279,1262603,67.31,3255.04
854,4080.178792,217,1262820,67.25,3255.04
855,4155.071882,270,1263090,67.18,3255.04
856,4163.489467,139,1263229,67.12,3255.04
857,4292.993186,261,1263490,67.13,3255.04
858,4326.027297,220,1263710,67.07,3255.04
859,4357.553275,198,1263908,67.09,3255.04
860,4359.584262,254,1264162,67.02,3255.04
861,4425.834986,207,1264369,67.04,3260.23
862,4481.433713,299,1264668,66.97,3260.23
863,4576.309714,171,1264839,66.91,3260.23
864,4571.982506,251,1265090,66.85,3260.23
865,4624.483940,140,1265230,66.78,3260.23
866,4547.101536,259,1265489,66.72,3260.23
867,4594.916517,221,1265710,66.74,3260.23
868,4582.853681,198,1265908,66.68,3260.23
869,4578.476204,252,1266160,66.69,3260.58
870,4644.052740,136,1266296,66.63,3260.58
871,4652.913792,260,1266556,66.65,3262.08
872,4632.585629,218,1266774,66.58,3262.08
873,4675.263320,196,1266970,66.52,3262.08
874,4732.560921,195,1267165,66.46,3262.08
875,4690.986033,129,1267294,66.39,3262.08
876,5767.529500,1,1267295,66.32,3262.08
877,0.000000,0,1267295,66.24,3262.08
878,0.000000,0,1267295,66.17,3262.08
879,8415.309202,1,1267296,66.09,3262.08
880,0.000000,0,1267296,66.02,3262.08
881,10090.213305,1,1267297,65.95,3262.08
882,0.000000,0,1267297,65.88,3262.08
883,0.000000,0,1267297,65.80,3262.08
884,13432.534840,33,1267330,65.74,3262.08
885,0.000000,0,1267330,65.67,3262.08
886,15180.703250,39,1267369,65.59,3262.08
887,0.000000,0,1267369,65.52,3262.08
888,0.000000,0,1267369,65.45,3262.08
889,18186.050842,1,1267370,65.37,3262.08
890,0.000000,0,1267370,65.30,3262.08
891,19649.363281,1,1267371,65.23,3262.08
892,0.000000,0,1267371,65.17,3244.73
893,21733.174269,298,1267669,65.19,3244.82
894,21754.789764,170,1267839,65.13,3244.57
895,21772.440867,198,1268037,65.14,3244.57
896,21780.017605,132,1268169,65.09,3244.57
897,18294.288777,201,1268370,65.08,3244.57
898,5239.075706,186,1268556,65.05,3244.57
899,5553.951008,154,1268710,64.99,3244.57
900,5790.748637,130,1268840,65.02,3250.20
901,6139.569362,115,1268955,64.95,3250.20
902,6507.894013,140,1269095,64.90,3250.20
903,6845.876855,134,1269229,64.83,3250.20
904,7112.716299,102,1269331,64.77,3250.73
905,7375.229892,159,1269490,64.79,3250.73
906,7617.137881,115,1269605,64.72,3250.73
907,7894.941791,70,1269675,64.82,3252.70
908,8232.326514,101,1269776,64.76,3252.70
909,8525.192533,130,1269906,64.70,3252.70
910,8695.472235,69,1269975,64.64,3252.70
911,8813.203028,183,1270158,64.58,3252.70
912,8926.384162,12,1270170,64.52,3252.70
913,9170.829839,129,1270299,64.46,3252.70
914,9373.472301,74,1270373,64.42,3252.70
915,9635.993017,121,1270494,64.50,3255.63
916,9922.314892,111,1270605,64.44,3255.63
917,10090.487412,69,1270674,64.45,3259.96
918,10193.014713,45,1270719,64.39,3259.96
919,10346.861549,121,1270840,64.34,3259.96
920,10634.082537,69,1270909,64.27,3259.96
921,10723.478182,129,1271038,64.21,3259.96
922,10724.963522,124,1271162,64.24,3259.96
923,10802.324595,67,1271229,64.17,3259.96
924,10814.588080,72,1271301,64.12,3259.96
925,10905.011991,73,1271374,64.13,3262.16
926,10902.317393,120,1271494,64.07,3262.16
927,10996.517516,111,1271605,64.09,3262.16
928,11001.715901,70,1271675,64.03,3262.16
929,10997.383998,46,1271721,63.97,3262.16
930,10985.600504,119,1271840,63.99,3263.69
931,11028.054747,68,1271908,63.94,3263.69
932,11216.008253,67,1271975,63.87,3263.69
933,11317.043352,121,1272096,63.82,3263.69
934,11328.735611,73,1272169,63.76,3263.69
935,11349.064302,129,1272298,63.77,3265.89
936,11360.997899,72,1272370,63.71,3265.89
937,11361.736828,120,1272490,63.74,3267.87
938,11349.866710,68,1272558,63.80,3267.87
939,11348.036560,113,1272671,63.78,3267.87
940,11345.392470,44,1272715,63.75,3267.87
941,11429.462077,108,1272823,63.73,3276.40
942,11452.512755,23,1272846,63.78,3295.23
943,11525.268409,68,1272914,63.77,3295.23
944,11625.220792,125,1273039,63.75,3295.23
945,11711.627514,124,1273163,63.77,3295.32
946,11683.679530,67,1273230,63.71,3295.32
947,11704.232622,72,1273302,63.73,3295.32
948,11639.563828,72,1273374,63.67,3295.32
949,11669.619910,120,1273494,63.61,3295.32
950,11774.233109,67,1273561,63.64,3295.32
951,11706.828678,114,1273675,63.59,3295.32
952,11733.577677,42,1273717,63.53,3295.32
953,11708.541296,122,1273839,63.47,3295.32
954,11616.067920,68,1273907,63.42,3295.32
955,11684.127681,18,1273925,63.42,3295.32
956,11749.087605,145,1274070,63.37,3295.32
957,11713.398033,97,1274167,63.39,3300.44
958,11574.378801,128,1274295,63.34,3300.44
959,11585.393928,39,1274334,63.28,3300.44
960,11603.198629,97,1274431,63.31,3303.52
961,11505.610983,110,1274541,63.25,3303.52
962,11500.109170,71,1274612,63.19,3303.52
963,11424.764186,101,1274713,63.14,3303.52
964,11421.777366,109,1274822,63.09,3303.52
965,11367.817054,26,1274848,63.04,3303.52
966,11317.804251,67,1274915,63.06,3303.52
967,11314.491355,124,1275039,63.07,3303.52
968,11309.623391,126,1275165,63.02,3303.52
969,11226.734702,68,1275233,62.96,3303.52
970,11281.867150,97,1275330,62.98,3303.52
971,11145.722141,99,1275429,62.93,3303.52
972,0.000000,0,1275429,62.87,3303.52
973,0.000000,0,1275429,62.81,3303.52
974,12610.781372,284,1275713,62.75,3303.52
975,0.000000,0,1275713,62.70,3303.52
976,0.000000,0,1275713,62.72,3303.52
977,11895.863757,192,1275905,62.74,3303.52
978,0.000000,0,1275905,62.68,3303.52
979,0.000000,0,1275905,62.62,3303.52
980,0.000000,0,1275905,62.56,3303.52
981,0.000000,0,1275905,62.51,3303.52
982,0.000000,0,1275905,62.45,3303.52
983,0.000000,0,1275905,62.40,3303.52
984,13333.205850,719,1276624,62.34,3303.52
985,11044.757451,65,1276689,62.29,3303.52
986,0.000000,0,1276689,62.22,3303.52
987,0.000000,0,1276689,62.16,3303.52
988,0.000000,0,1276689,62.13,3303.52
989,0.000000,0,1276689,62.17,3303.52
990,8189.447221,844,1277533,62.16,3303.52
991,2398.288442,650,1278183,62.15,3303.52
992,1497.940071,715,1278898,62.22,3303.52
993,1526.246280,715,1279613,62.27,3303.52
994,1317.717300,715,1280328,62.28,3303.52
995,1430.695086,715,1281043,62.24,3303.52
996,1404.956576,529,1281572,62.23,3303.57
997,1601.009404,834,1282406,62.25,3303.61
998,1363.081186,586,1282992,62.35,3303.61
999,1783.422184,260,1283252,62.31,3303.61
1000,2229.366134,518,1283770,62.25,3303.61
1001,2611.647774,327,1284097,62.21,3303.61
1002,2538.183116,390,1284487,62.16,3303.61
1003,2655.456735,347,1284834,62.11,3303.61
1004,2768.781611,328,1285162,62.06,3303.61
1005,2793.834844,351,1285513,62.02,3303.61
1006,2974.985907,321,1285834,62.04,3303.61
1007,3151.073163,264,1286098,62.06,3303.61
1008,3273.308616,388,1286486,62.08,3303.61
1009,3312.156214,220,1286706,62.04,3303.61
1010,3357.760906,233,1286939,61.99,3303.61
1011,3542.647338,290,1287229,61.94,3303.61
1012,3664.979839,260,1287489,61.89,3303.61
1013,3660.172064,345,1287834,61.84,3303.79
1014,3605.282363,263,1288097,61.80,3303.79
1015,3566.735271,262,1288359,61.75,3303.79
1016,3587.592084,283,1288642,61.78,3303.79
1017,3553.554031,297,1288939,61.81,3303.79
1018,3527.863480,225,1289164,61.82,3303.79
1019,3555.542149,325,1289489,61.78,3303.79
1020,3594.442941,284,1289773,61.73,3303.79
1021,3584.171613,234,1290007,61.68,3303.79
1022,3576.797812,290,1290297,61.63,3303.79
1023,3672.613763,258,1290555,61.58,3303.79
1024,3653.216770,347,1290902,61.53,3303.79
1025,3580.742396,262,1291164,61.48,3303.79
1026,3582.339942,323,1291487,61.49,3303.79
1027,3566.634985,221,1291708,61.52,3303.79
1028,3508.723873,299,1292007,61.47,3303.79
1029,3480.295736,227,1292234,61.41,3303.79
1030,3552.179007,257,1292491,61.37,3303.79
1031,3537.560806,411,1292902,61.31,3303.79
1032,3490.394929,264,1293166,61.27,3303.79
1033,3469.656593,321,1293487,61.21,3303.79
1034,3376.904727,222,1293709,61.17,3303.79
1035,3539.423223,297,1294006,61.15,3303.79
1036,3610.586921,228,1294234,61.13,3303.79
1037,3491.838906,322,1294556,61.16,3303.79
1038,3467.199481,287,1294843,61.11,3303.79
1039,3456.742478,296,1295139,61.06,3303.79
1040,3489.214426,287,1295426,61.02,3303.79
1041,3559.304845,283,1295709,60.97,3303.79
1042,3576.786723,297,1296006,60.92,3303.79
1043,3614.681107,228,1296234,60.88,3303.43
1044,3586.236061,323,1296557,60.89,3303.43
1045,3610.664955,285,1296842,60.91,3303.99
1046,3716.612560,172,1297014,60.87,3303.99
1047,3620.285775,326,1297340,60.90,3303.99
1048,3658.027426,307,1297647,60.85,3303.99
1049,3554.949630,322,1297969,60.81,3303.99
1050,3598.750131,201,1298170,60.76,3303.99
1051,3623.860291,260,1298430,60.72,3303.99
1052,3691.904487,284,1298714,60.67,3303.99
1053,3651.055394,295,1299009,60.66,3303.99
1054,3638.286392,292,1299301,60.65,3303.99
1055,3576.752380,307,1299608,60.67,3303.99
1056,3595.606051,297,1299905,60.63,3303.99
1057,3626.462940,177,1300082,60.66,3303.99
1058,3707.013055,261,1300343,60.61,3303.99
1059,3626.750745,371,1300714,60.57,3303.99
1060,3599.123279,256,1300970,60.53,3303.99
1061,3563.199380,266,1301236,60.48,3304.20
1062,3613.487575,199,1301435,60.43,3304.20
1063,3644.493943,368,1301803,60.45,3304.20
1064,3640.354339,215,1302018,60.41,3304.20
1065,3532.232189,322,1302340,60.43,3304.20
1066,3687.125182,269,1302609,60.38,3304.20
1067,3655.749662,302,1302911,60.41,3304.20
1068,3758.975316,174,1303085,60.37,3304.20
1069,3725.407714,285,1303370,60.32,3304.20
1070,3630.205195,345,1303715,60.28,3304.20
1071,3610.259175,259,1303974,60.24,3304.45
1072,3699.642440,263,1304237,60.19,3304.45
1073,3780.832884,201,1304438,60.21,3304.45
1074,3795.481438,331,1304769,60.16,3304.45
1075,3798.112808,207,1304976,60.19,3304.45
1076,3854.138960,265,1305241,60.15,3304.45
1077,3792.584141,261,1305502,60.18,3304.45
1078,3783.937761,348,1305850,60.13,3304.45
1079,3757.799623,170,1306020,60.09,3304.45
1080,3785.580941,284,1306304,60.04,3304.45
1081,3812.694004,263,1306567,60.00,3304.45
1082,3983.327667,279,1306846,59.98,3304.45
1083,3963.186910,176,1307022,60.06,3304.45
1084,4013.623826,282,1307304,60.07,3304.45
1085,4055.015036,263,1307567,60.06,3304.45
1086,4059.595141,281,1307848,60.05,3304.45
1087,3997.985618,173,1308021,60.10,3304.45
1088,4030.853706,258,1308279,60.10,3314.92
1089,4090.909590,225,1308504,60.15,3316.94
1090,4229.273373,277,1308781,60.10,3317.12
1091,4281.449902,196,1308977,60.06,3317.12
1092,4348.447127,240,1309217,60.01,3317.12
1093,4431.834772,221,1309438,60.04,3317.12
1094,4379.679466,197,1309635,59.99,3317.12
1095,4509.884755,279,1309914,59.95,3317.12
1096,4651.008367,110,1310024,59.90,3317.12
1097,4596.002107,218,1310242,59.92,3317.12
1098,4673.664476,200,1310442,59.95,3317.12
1099,4715.700251,237,1310679,59.90,3317.12
1100,4701.868306,292,1310971,59.86,3317.12
1101,4710.909194,119,1311090,59.82,3317.12
1102,4769.626594,197,1311287,59.77,3317.12
1103,4777.786282,279,1311566,59.79,3317.12
1104,4846.801954,178,1311744,59.75,3317.12
1105,4859.302251,231,1311975,59.71,3317.12
1106,4873.026311,150,1312125,59.66,3317.12
1107,4862.728810,184,1312309,59.69,3317.12
1108,4849.724772,260,1312569,59.71,3317.12
1109,4896.770472,175,1312744,59.67,3317.12
1110,4901.294741,234,1312978,59.62,3317.31
1111,4856.143965,175,1313153,59.58,3317.31
1112,4894.951135,136,1313289,59.54,3317.31
1113,5469.963485,1,1313290,59.55,3320.12
1114,0.000000,0,1313290,59.51,3320.12
1115,7059.786359,19,1313309,59.46,3320.12
1116,8681.517897,129,1313438,59.41,3320.12
1117,8638.545564,176,1313614,59.36,3320.12
1118,8668.745762,235,1313849,59.32,3320.12
1119,8759.575648,175,1314024,59.27,3320.12
1120,8721.891165,199,1314223,59.30,3322.76
1121,8161.985566,89,1314312,59.25,3322.76
1122,5323.271753,195,1314507,59.21,3322.76
1123,5630.826522,130,1314637,59.21,3322.76
1124,5965.679909,174,1314811,59.18,3322.76
1125,6194.617851,167,1314978,59.14,3322.76
1126,6546.604335,112,1315090,59.09,3322.76
1127,6678.886748,165,1315255,59.05,3322.76
1128,6825.118532,119,1315374,59.06,3322.76
1129,7138.695346,72,1315446,59.01,3322.76
1130,7490.971541,127,1315573,58.96,3322.76
1131,7643.266557,67,1315640,58.92,3322.76
1132,7902.021380,209,1315849,58.87,3322.76
1133,7928.763248,130,1315979,58.84,3322.76
1134,7984.833471,112,1316091,58.85,3323.20
1135,7800.891960,198,1316289,58.87,3323.20
1136,7781.404156,90,1316379,58.83,3323.20
1137,7787.299337,70,1316449,58.79,3323.20
1138,7815.625120,165,1316614,58.81,3323.20
1139,6913.930664,302,1316916,58.77,3323.20
1140,6670.170634,74,1316990,58.73,3323.20
1141,6669.114061,228,1317218,58.69,3323.20
1142,6678.405570,74,1317292,58.65,3323.20
1143,6742.595898,146,1317438,58.60,3323.20
1144,6803.671083,72,1317510,58.62,3324.65
1145,6747.112221,172,1317682,58.64,3324.65
1146,6897.309331,235,1317917,58.60,3324.65
1147,6891.135345,74,1317991,58.56,3324.65
1148,7030.279854,228,1318219,58.57,3324.65
1149,6966.331024,74,1318293,58.54,3324.65
1150,6971.187206,145,1318438,58.51,3324.65
1151,7046.368828,72,1318510,58.46,3324.65
1152,7063.952103,106,1318616,58.42,3324.65
1153,7076.114965,298,1318914,58.38,3324.65
1154,7082.380811,78,1318992,58.34,3324.65
1155,7108.029949,166,1319158,58.37,3324.65
1156,7104.610245,134,1319292,58.39,3326.45
1157,7111.996900,147,1319439,58.40,3326.45
1158,7087.972878,12,1319451,58.43,3326.45
1159,7149.768192,126,1319577,58.41,3326.45
1160,7141.133393,337,1319914,58.40,3326.45
1161,7201.486197,69,1319983,58.39,3326.45
1162,7223.618116,112,1320095,58.37,3337.62
1163,7180.259251,164,1320259,58.42,3341.85
1164,7234.235350,122,1320381,58.40,3341.85
1165,7177.863666,69,1320450,58.41,3342.53
1166,7230.052460,123,1320573,58.44,3342.53
1167,7198.744679,238,1320811,58.40,3342.53
1168,7257.662479,167,1320978,58.35,3342.53
1169,7249.096621,54,1321032,58.31,3342.53
1170,7245.468028,225,1321257,58.27,3342.53
1171,7169.091872,104,1321361,58.23,3342.53
1172,7237.471089,87,1321448,58.26,3342.53
1173,7083.169874,124,1321572,58.22,3342.53
1174,7104.359071,239,1321811,58.18,3342.53
1175,7068.573228,167,1321978,58.16,3342.53
1176,6990.414728,54,1322032,58.22,3342.53
1177,7014.128882,225,1322257,58.17,3342.53
1178,6929.405296,123,1322380,58.13,3342.53
1179,6955.093155,70,1322450,58.10,3342.53
1180,6876.985842,124,1322574,58.05,3342.97
1181,6905.532786,238,1322812,58.01,3342.97
1182,6923.292899,171,1322983,58.01,3342.97
1183,6869.947293,113,1323096,58.00,3344.79
1184,6895.583957,163,1323259,57.96,3344.79
1185,6800.699088,125,1323384,57.92,3344.79
1186,6848.842376,69,1323453,58.00,3345.23
1187,6788.913558,164,1323617,57.96,3345.23
1188,6694.829799,196,1323813,57.92,3345.23
1189,7263.576832,170,1323983,57.88,3345.23
1190,0.000000,0,1323983,57.84,3345.23
1191,7336.569520,275,1324258,57.80,3345.23
1192,0.000000,0,1324258,57.75,3345.23
1193,0.000000,0,1324258,57.71,3345.23
1194,8048.893203,317,1324575,57.67,3345.23
1195,0.000000,0,1324575,57.63,3337.96
1196,0.000000,0,1324575,57.64,3337.96
1197,9233.300105,310,1324885,57.60,3337.96
1198,0.000000,0,1324885,57.55,3337.96
1199,0.000000,0,1324885,57.51,3337.96
1200,0.000000,0,1324885,57.46,3337.96
1201,0.000000,0,1324885,57.41,3337.96
1202,12521.199647,65,1324950,57.37,3337.96
1203,13264.871003,65,1325015,57.32,3337.96
1204,0.000000,0,1325015,57.28,3337.96
1205,0.000000,0,1325015,57.24,3337.96
1206,15257.189467,65,1325080,57.19,3337.96
1207,14637.134113,390,1325470,57.21,3337.96
1208,7466.438776,778,1326248,57.18,3337.96
1209,1469.008047,649,1326897,57.16,3337.96
1210,1547.448563,519,1327416,57.20,3337.96
1211,1373.412358,845,1328261,57.16,3337.96
1212,1377.049280,520,1328781,57.14,3337.96
1213,1478.148045,910,1329691,57.16,3337.96
1214,1423.248642,714,1330405,57.20,3337.96
1215,1452.615331,715,1331120,57.17,3337.96
1216,1356.436108,585,1331705,57.14,3337.96
1217,1439.853169,585,1332290,57.11,3337.96
1218,1476.234932,845,1333135,57.08,3337.96
1219,1433.387831,585,1333720,57.19,3337.96
1220,1401.025045,779,1334499,57.21,3337.96
1221,1435.548626,585,1335084,57.18,3337.96
1222,1466.515034,844,1335928,57.16,3337.96
1223,1591.974553,390,1336318,57.12,3337.96
1224,2199.996429,260,1336578,57.08,3337.96
1225,2524.069428,520,1337098,57.05,3337.96
1226,2497.577800,391,1337489,57.07,3337.96
1227,2438.088231,401,1337890,57.11,3337.96
1228,2615.325108,340,1338230,57.10,3337.96
1229,2714.670015,348,1338578,57.16,3337.96
1230,2757.901741,378,1338956,57.15,3337.96
1231,2855.986230,339,1339295,57.14,3352.31
1232,2891.178172,283,1339578,57.19,3355.30
1233,3018.800452,378,1339956,57.18,3355.30
1234,3015.349368,339,1340295,57.17,3355.30
1235,3047.077450,261,1340556,57.14,3355.47
1236,3128.741477,398,1340954,57.11,3355.47
1237,3125.846916,277,1341231,57.13,3355.47
1238,3133.929926,260,1341491,57.10,3355.47
1239,3205.797039,333,1341824,57.18,3355.47
1240,3338.732578,347,1342171,57.14,3355.47
1241,3382.867805,255,1342426,57.11,3355.47
1242,3350.328043,273,1342699,57.07,3355.47
1243,3383.041667,325,1343024,57.04,3355.47
1244,3280.802005,274,1343298,57.00,3355.47
1245,3303.902420,262,1343560,56.97,3355.47
1246,3361.115298,331,1343891,56.93,3355.47
1247,3363.249087,405,1344296,56.95,3355.47
1248,3279.766676,198,1344494,56.92,3355.47
1249,3361.177625,233,1344727,56.98,3355.47
1250,3431.165169,297,1345024,56.97,3355.47
1251,3574.829313,402,1345426,56.94,3355.47
1252,3505.614859,200,1345626,56.91,3355.47
1253,3605.191007,266,1345892,56.86,3355.47
1254,3606.087540,281,1346173,56.83,3355.47
1255,3705.619529,303,1346476,56.80,3355.47
1256,3716.513374,216,1346692,56.76,3355.47
1257,3739.938624,265,1346957,56.75,3355.47
1258,3748.037535,275,1347232,56.75,3355.47
1259,3758.265174,264,1347496,56.71,3355.47
1260,3708.612743,273,1347769,56.74,3355.47
1261,3604.891706,259,1348028,56.70,3355.47
1262,3668.699866,280,1348308,56.67,3355.47
1263,3657.766905,256,1348564,56.62,3355.47
1264,3653.356584,328,1348892,56.59,3355.47
1265,3734.416956,265,1349157,56.55,3355.47
1266,3666.898182,272,1349429,56.51,3355.47
1267,3617.768668,265,1349694,56.48,3355.47
1268,3595.018671,266,1349960,56.50,3355.47
1269,3699.613493,337,1350297,56.47,3355.47
1270,3762.844207,198,1350495,56.49,3355.47
1271,3887.380939,209,1350704,56.46,3355.47
1272,3919.154885,258,1350962,56.42,3355.47
1273,3834.123249,335,1351297,56.38,3355.47
1274,3888.799751,198,1351495,56.35,3355.47
1275,3900.018165,276,1351771,56.31,3355.47
1276,3881.767080,194,1351965,56.28,3355.47
1277,3855.770182,343,1352308,56.27,3355.47
1278,3821.944762,252,1352560,56.33,3355.47
1279,3812.563077,212,1352772,56.30,3355.47
1280,3896.041106,199,1352971,56.33,3355.47
1281,3962.038072,337,1353308,56.34,3355.47
1282,4072.111966,255,1353563,56.33,3355.47
1283,4085.733502,210,1353773,56.33,3355.47
1284,3963.419427,257,1354030,56.38,3356.71
1285,4013.380776,281,1354311,56.37,3356.71
1286,3977.905898,186,1354497,56.36,3356.71
1287,4144.812897,212,1354709,56.38,3356.71
1288,4173.737880,256,1354965,56.37,3356.71
1289,4226.818975,326,1355291,56.33,3356.71
1290,4225.998988,205,1355496,56.30,3356.71
1291,4247.500076,137,1355633,56.36,3356.71
1292,4309.867533,325,1355958,56.36,3356.71
1293,4290.142666,203,1356161,56.33,3356.71
1294,4557.134215,152,1356313,56.30,3356.71
1295,4594.030730,245,1356558,56.27,3356.71
1296,4596.877578,153,1356711,56.23,3356.71
1297,4578.520317,319,1357030,56.20,3356.71
1298,4544.656331,200,1357230,56.22,3356.71
1299,4609.914998,202,1357432,56.19,3356.71
1300,4674.397716,139,1357571,56.15,3356.71
1301,4642.847328,208,1357779,56.11,3356.71
1302,4698.761467,318,1358097,56.18,3361.19
1303,4649.629123,197,1358294,56.16,3361.19
1304,4646.214851,205,1358499,56.13,3361.19
1305,4641.409724,199,1358698,56.09,3361.19
1306,4689.024947,253,1358951,56.06,3361.19
1307,5008.335516,148,1359099,56.03,3361.19
1308,4990.181305,195,1359294,56.05,3366.39
1309,4953.953643,142,1359436,56.01,3366.39
1310,5734.479890,1,1359437,55.97,3366.39
1311,0.000000,0,1359437,55.93,3366.39
1312,7707.635539,62,1359499,55.89,3366.39
1313,8220.659594,134,1359633,55.85,3366.39
1314,8267.738442,252,1359885,55.82,3366.39
1315,8250.886550,209,1360094,55.84,3367.75
1316,8264.020734,137,1360231,55.81,3367.75
1317,8276.702572,202,1360433,55.77,3367.75
1318,5497.066412,134,1360567,55.75,3367.75
1319,5642.914022,134,1360701,55.75,3367.75
1320,5971.652469,139,1360840,55.72,3367.75
1321,6059.130452,126,1360966,55.68,3367.75
1322,6362.478677,197,1361163,55.65,3367.75
1323,6718.462937,130,1361293,55.62,3369.20
1324,7016.486355,139,1361432,55.64,3375.59
1325,7286.209524,55,1361487,55.60,3375.59
1326,7916.326751,81,1361568,55.56,3375.59
1327,7916.554558,135,1361703,55.53,3375.59
1328,7873.618470,137,1361840,55.49,3375.59
1329,7916.729353,191,1362031,55.51,3379.18
1330,7995.607018,132,1362163,55.53,3379.18
1331,7990.498796,129,1362292,55.50,3379.18
1332,7999.602232,141,1362433,55.46,3379.18
1333,8009.069979,62,1362495,55.43,3379.18
1334,8004.935898,75,1362570,55.45,3379.18
1335,7937.064267,133,1362703,55.42,3379.18
1336,7789.716515,290,1362993,55.38,3379.18
1337,7011.466203,170,1363163,55.35,3379.18
1338,6972.340341,132,1363295,55.32,3379.18
1339,7052.752448,139,1363434,55.28,3379.18
1340,6983.927274,62,1363496,55.36,3379.18
1341,7032.045550,74,1363570,55.32,3379.53
1342,7021.184524,134,1363704,55.29,3379.53
1343,7077.987315,162,1363866,55.25,3379.53
1344,7216.116669,237,1364103,55.22,3379.53
1345,7184.552594,189,1364292,55.25,3379.48
1346,7221.483841,137,1364429,55.23,3379.48
1347,7143.567970,58,1364487,55.23,3379.57
1348,7218.049733,77,1364564,55.22,3379.57
1349,7246.849582,78,1364642,55.21,3379.57
1350,7289.525058,133,1364775,55.25,3380.09
1351,7359.632887,323,1365098,55.36,3381.91
1352,7424.571791,76,1365174,55.35,3381.91
1353,7431.380027,144,1365318,55.35,3381.91
1354,7475.910230,122,1365440,55.31,3381.91
1355,7504.573811,64,1365504,55.28,3381.91
1356,7478.096703,69,1365573,55.24,3381.91
1357,7600.083113,133,1365706,55.21,3381.91
1358,7580.490964,226,1365932,55.18,3381.91
1359,7541.293655,174,1366106,55.21,3381.91
1360,7554.408855,188,1366294,55.17,3381.91
1361,7437.904535,137,1366431,55.25,3382.44
1362,7488.556952,66,1366497,55.22,3382.44
1363,7411.487111,74,1366571,55.18,3382.44
1364,7347.662872,74,1366645,55.15,3382.44
1365,7249.372930,194,1366839,55.11,3382.44
1366,7362.704427,260,1367099,55.08,3382.44
1367,7343.453197,75,1367174,55.05,3382.44
1368,7394.949984,148,1367322,55.02,3382.44
1369,7330.246393,122,1367444,54.99,3382.44
1370,7252.126251,68,1367512,55.01,3387.10
1371,7288.463866,124,1367636,55.00,3387.10
1372,7249.732352,97,1367733,55.06,3389.21
1373,7297.353504,365,1368098,55.03,3389.21
1374,7246.842818,71,1368169,55.00,3389.21
1375,7222.589625,151,1368320,54.96,3389.21
1376,7148.568219,2,1368322,54.93,3389.21
1377,7779.523332,120,1368442,54.89,3389.21
1378,0.000000,0,1368442,54.88,3389.21
1379,0.000000,0,1368442,54.87,3389.21
1380,0.000000,0,1368442,54.90,3389.21
1381,8754.305592,658,1369100,54.90,3389.21
1382,0.000000,0,1369100,54.91,3389.21
1383,0.000000,0,1369100,54.93,3389.21
1384,9178.965805,287,1369387,54.92,3389.21
1385,0.000000,0,1369387,54.91,3395.28
1386,0.000000,0,1369387,54.87,3395.28
1387,0.000000,0,1369387,54.84,3395.28
1388,0.000000,0,1369387,54.80,3395.28
1389,0.000000,0,1369387,54.76,3395.28
1390,0.000000,0,1369387,54.72,3395.28
1391,0.000000,0,1369387,54.69,3395.28
1392,0.000000,0,1369387,54.65,3395.28
1393,0.000000,0,1369387,54.61,3395.28
1394,0.000000,0,1369387,54.58,3395.28
1395,14576.476467,649,1370036,54.58,3395.28
1396,9599.450785,453,1370489,54.59,3395.28
1397,1476.230934,874,1371363,54.56,3395.28
1398,1410.203686,762,1372125,54.59,3395.28
1399,1321.897071,509,1372634,54.57,3395.28
1400,1465.109244,780,1373414,54.60,3395.28
1401,1456.324285,845,1374259,54.63,3402.67
1402,1404.118290,650,1374909,54.61,3402.67
1403,1452.401161,649,1375558,54.58,3402.67
1404,1423.351576,781,1376339,54.56,3402.67
1405,1430.527141,715,1377054,54.54,3402.67
1406,1395.076115,627,1377681,54.57,3402.67
1407,1485.124158,550,1378231,54.60,3402.67
1408,1421.547539,902,1379133,54.64,3402.67
1409,1364.705245,714,1379847,54.62,3402.67
1410,1457.391275,585,1380432,54.59,3402.67
1411,1863.327470,390,1380822,54.56,3402.67
1412,2174.104812,391,1381213,54.53,3402.67
1413,2433.456816,389,1381602,54.55,3402.67
1414,2422.743973,391,1381993,54.53,3402.67
1415,2498.435430,478,1382471,54.50,3402.67
1416,2612.872314,263,1382734,54.47,3402.67
1417,2704.288642,352,1383086,54.43,3402.67
1418,2881.245907,362,1383448,54.46,3402.67
1419,2926.463810,286,1383734,54.43,3402.67
1420,3019.372874,325,1384059,54.40,3402.67
1421,3094.924309,325,1384384,54.37,3402.67
1422,3137.308213,349,1384733,54.34,3402.67
1423,3207.480508,325,1385058,54.31,3402.67
1424,3197.401286,260,1385318,54.33,3402.67
1425,3182.283324,351,1385669,54.30,3402.67
1426,3200.244440,260,1385929,54.27,3402.67
1427,3380.725582,263,1386192,54.24,3402.67
1428,3407.652120,348,1386540,54.21,3402.67
1429,3389.669901,262,1386802,54.23,3402.67
1430,3455.745765,257,1387059,54.21,3402.67
1431,3449.721093,326,1387385,54.18,3402.67
1432,3453.911422,348,1387733,54.15,3402.67
1433,3488.322902,198,1387931,54.13,3402.67
1434,3515.986830,262,1388193,54.12,3402.67
1435,3707.007489,257,1388450,54.17,3402.67
1436,3816.598428,286,1388736,54.15,3402.67
1437,3847.381013,260,1388996,54.12,3402.67
1438,3816.570381,198,1389194,54.09,3402.67
1439,3775.807844,349,1389543,54.10,3402.67
1440,3711.778259,260,1389803,54.09,3402.67
1441,3754.174806,258,1390061,54.06,3402.67
1442,3718.167554,316,1390377,54.03,3402.67
1443,3649.223454,303,1390680,54.01,3402.67
1444,3601.551974,186,1390866,53.98,3402.67
1445,3658.575431,325,1391191,54.00,3402.67
1446,3618.774504,262,1391453,54.03,3402.67
1447,3710.103537,286,1391739,54.00,3402.67
1448,3712.030442,193,1391932,53.97,3402.67
1449,3741.469906,259,1392191,53.94,3402.67
1450,3802.922909,328,1392519,53.97,3402.67
1451,3856.175341,220,1392739,53.94,3402.67
1452,3909.664056,194,1392933,53.91,3402.67
1453,3950.612324,263,1393196,53.88,3402.67
1454,4037.158106,322,1393518,53.85,3402.67
1455,4144.768025,221,1393739,53.87,3402.67
1456,4006.690854,196,1393935,53.90,3402.67
1457,3985.622578,262,1394197,53.87,3402.67
1458,4070.844595,321,1394518,53.84,3402.67
1459,3984.732051,222,1394740,53.81,3402.67
1460,3990.555393,196,1394936,53.80,3402.67
1461,4104.588605,260,1395196,53.85,3402.67
1462,4038.539502,260,1395456,53.84,3402.67
1463,4133.111593,283,1395739,53.87,3402.67
1464,4092.755126,197,1395936,53.88,3402.67
1465,4042.452268,261,1396197,53.90,3402.67
1466,3998.428047,259,1396456,53.92,3402.67
1467,4070.644445,222,1396678,53.92,3402.67
1468,4255.350865,254,1396932,53.89,3402.67
1469,4411.704219,137,1397069,53.86,3402.67
1470,4322.589743,265,1397334,53.89,3402.67
1471,4431.917561,219,1397553,53.88,3402.67
1472,4409.323105,254,1397807,53.89,3402.67
1473,4397.656427,176,1397983,53.86,3402.67
1474,4509.641554,279,1398262,53.83,3402.67
1475,4579.286396,132,1398394,53.80,3402.67
1476,4557.925508,285,1398679,53.82,3402.67
1477,4598.554610,216,1398895,53.80,3402.67
1478,4555.964030,173,1399068,53.77,3402.67
1479,4589.924874,201,1399269,53.74,3402.67
1480,4689.180426,250,1399519,53.71,3402.67
1481,4797.127607,222,1399741,53.74,3410.27
1482,4818.211926,193,1399934,53.75,3410.27
1483,4776.588310,138,1400072,53.73,3410.27
1484,4762.691496,264,1400336,53.70,3410.27
1485,4888.013372,187,1400523,53.68,3410.27
1486,4847.365348,221,1400744,53.65,3410.27
1487,4813.129118,194,1400938,53.67,3410.27
1488,4824.138940,200,1401138,53.64,3410.27
1489,4940.859511,198,1401336,53.61,3410.27
1490,4998.763962,185,1401521,53.58,3410.27
1491,5034.186344,223,1401744,53.59,3410.27
1492,4995.360049,127,1401871,53.58,3410.27
1493,5758.304713,62,1401933,53.55,3410.27
1494,0.000000,0,1401933,53.52,3410.27
1495,7935.641513,34,1401967,53.49,3410.27
1496,7938.100980,173,1402140,53.51,3410.27
1497,7941.630041,198,1402338,53.48,3410.27
1498,7914.840668,186,1402524,53.50,3410.27
1499,7955.664866,220,1402744,53.47,3410.27
1500,7829.777195,192,1402936,53.44,3410.27
1501,5453.876204,70,1403006,53.41,3410.27
1502,5810.422713,134,1403140,53.38,3410.27
1503,6118.332281,134,1403274,53.35,3410.27
1504,6465.724004,184,1403458,53.38,3410.27
1505,6689.344201,69,1403527,53.34,3410.27
1506,7046.492355,157,1403684,53.31,3410.27
1507,7205.496114,190,1403874,53.28,3410.27
1508,7212.185293,130,1404004,53.28,3410.27
1509,7156.785999,135,1404139,53.27,3410.95
1510,7191.826517,132,1404271,53.24,3410.95
1511,7199.615926,126,1404397,53.21,3410.95
1512,7147.733070,129,1404526,53.18,3410.95
1513,7158.837964,156,1404682,53.15,3410.95
1514,7168.222037,191,1404873,53.12,3410.95
1515,7198.761841,114,1404987,53.14,3410.95
1516,7174.659806,90,1405077,53.12,3410.95
1517,7182.800714,193,1405270,53.09,3410.95
1518,7168.478784,72,1405342,53.06,3410.95
1519,7159.910018,182,1405524,53.05,3411.64
1520,7220.432203,156,1405680,53.08,3414.45
1521,7198.442974,132,1405812,53.07,3414.45
1522,7168.107727,173,1405985,53.04,3414.45
1523,7153.369825,89,1406074,53.01,3414.45
1524,7239.119465,191,1406265,52.99,3414.45
1525,7200.285964,77,1406342,52.96,3414.45
1526,7167.191679,180,1406522,52.98,3414.45
1527,7201.757659,94,1406616,52.95,3414.45
1528,7183.553663,132,1406748,52.93,3414.45
1529,7146.891207,235,1406983,52.90,3414.45
1530,7156.756816,90,1407073,52.91,3414.45
1531,7113.351958,134,1407207,52.94,3414.45
1532,7068.082169,132,1407339,52.91,3414.45
1533,7063.118342,183,1407522,52.89,3414.45
1534,7130.274147,73,1407595,52.86,3414.81
1535,7102.638648,153,1407748,52.83,3414.81
1536,7077.395949,194,1407942,52.80,3414.81
1537,7064.457745,129,1408071,52.83,3416.94
1538,7056.547680,131,1408202,52.82,3416.94
1539,7102.618189,137,1408339,52.82,3416.94
1540,7064.881678,131,1408470,52.81,3416.94
1541,7057.913913,125,1408595,52.85,3416.94
1542,7149.077597,153,1408748,52.89,3417.02
1543,7089.687094,193,1408941,52.94,3417.02
1544,7109.990183,130,1409071,52.94,3417.02
1545,7024.988457,75,1409146,52.93,3417.02
1546,7063.133499,193,1409339,52.90,3417.02
1547,7018.105982,124,1409463,52.88,3417.02
1548,7053.558880,106,1409569,52.85,3417.02
1549,7006.400216,179,1409748,52.82,3417.02
1550,6959.116418,193,1409941,52.79,3417.02
1551,6986.269643,130,1410071,52.80,3417.02
1552,6951.243754,132,1410203,52.84,3417.02
1553,6880.357143,139,1410342,52.86,3418.47
1554,6792.036859,181,1410523,52.84,3418.47
1555,6752.031722,75,1410598,52.81,3418.47
1556,6713.517128,218,1410816,52.78,3418.47
1557,6671.609148,171,1410987,52.76,3418.47
1558,6611.739231,90,1411077,52.73,3418.47
1559,6565.390491,196,1411273,52.70,3418.47
1560,6575.234177,128,1411401,52.67,3418.47
1561,6488.194736,132,1411533,52.65,3418.47
1562,6499.030816,212,1411745,52.64,3430.68
1563,6483.404814,196,1411941,52.72,3435.97
1564,6460.015193,71,1412012,52.75,3435.97
1565,6480.144970,192,1412204,52.75,3435.97
1566,6410.972514,140,1412344,52.74,3435.97
1567,6354.672557,182,1412526,52.74,3435.97
1568,6252.459047,138,1412664,52.77,3436.06
1569,6577.105811,264,1412928,52.77,3436.06
1570,0.000000,0,1412928,52.77,3436.06
1571,6869.488127,150,1413078,52.74,3436.06
1572,0.000000,0,1413078,52.71,3436.06
1573,7104.740563,269,1413347,52.68,3436.06
1574,0.000000,0,1413347,52.65,3436.06
1575,0.000000,0,1413347,52.68,3436.06
1576,0.000000,0,1413347,52.64,3436.06
1577,0.000000,0,1413347,52.61,3436.06
1578,0.000000,0,1413347,52.58,3436.06
1579,0.000000,0,1413347,52.54,3436.06
1580,0.000000,0,1413347,52.51,3436.06
1581,0.000000,0,1413347,52.48,3436.06
1582,0.000000,0,1413347,52.45,3436.06
1583,13908.119732,705,1414052,52.43,3436.06
1584,0.000000,0,1414052,52.40,3436.06
1585,0.000000,0,1414052,52.37,3436.06
1586,0.000000,0,1414052,52.34,3436.06
1587,0.000000,0,1414052,52.31,3436.06
1588,15806.951906,66,1414118,52.28,3436.06
1589,9609.115799,715,1414833,52.31,3436.06
1590,3284.714953,649,1415482,52.28,3436.06
1591,1521.833191,585,1416067,52.26,3436.06
1592,1461.554361,844,1416911,52.30,3436.06
1593,1337.967859,584,1417495,52.28,3436.06
1594,1488.896463,652,1418147,52.31,3436.06
1595,1408.212118,844,1418991,52.29,3436.06
1596,1351.855151,455,1419446,52.28,3436.06
1597,1561.072714,910,1420356,52.26,3436.06
1598,1403.959272,714,1421070,52.23,3436.06
1599,1415.940159,578,1421648,52.21,3436.06
1600,1381.401583,853,1422501,52.23,3436.06
1601,1418.844335,518,1423019,52.21,3436.06
1602,1637.258646,846,1423865,52.21,3436.06
1603,1143.423759,519,1424384,52.22,3436.06
1604,1541.834297,715,1425099,52.20,3436.06
1605,1829.628137,454,1425553,52.18,3436.06
1606,2107.264571,457,1426010,52.16,3436.06
1607,2084.071871,455,1426465,52.23,3436.06
1608,2161.838059,325,1426790,52.21,3436.06
1609,2534.390435,414,1427204,52.18,3436.06
1610,2745.097308,390,1427594,52.16,3436.06
1611,2748.542311,325,1427919,52.13,3436.06
1612,2776.620299,279,1428198,52.11,3436.06
1613,2879.685398,396,1428594,52.14,3436.06
1614,2899.978903,391,1428985,52.12,3436.06
1615,2875.952565,349,1429334,52.09,3436.06
1616,2881.646388,325,1429659,52.07,3436.06
1617,2997.793147,317,1429976,52.09,3436.06
1618,3040.235179,302,1430278,52.12,3436.06
1619,3056.663959,317,1430595,52.10,3436.06
1620,3017.929427,369,1430964,52.08,3436.06
1621,3125.891033,250,1431214,52.05,3436.06
1622,3086.685245,380,1431594,52.03,3436.06
1623,3171.663040,263,1431857,52.00,3436.06
1624,3291.927670,324,1432181,52.03,3436.06
1625,3285.423404,290,1432471,52.01,3436.06
1626,3257.238983,258,1432729,51.99,3436.06
1627,3201.380542,325,1433054,51.96,3436.06
1628,3371.529867,283,1433337,52.02,3436.06
1629,3480.172365,260,1433597,52.01,3436.06
1630,3506.672148,330,1433927,51.99,3436.06
1631,3555.751099,256,1434183,51.96,3436.06
1632,3566.633154,287,1434470,51.94,3436.06
1633,3618.854131,261,1434731,51.91,3436.06
1634,3686.922125,246,1434977,51.89,3436.06
1635,3822.907091,207,1435184,51.92,3436.06
1636,3775.889419,352,1435536,51.89,3436.06
1637,3806.266459,259,1435795,51.87,3436.06
1638,3770.268212,258,1436053,51.87,3436.06
1639,3749.418823,240,1436293,51.91,3436.06
1640,3840.411004,301,1436594,51.89,3436.06
1641,3814.496616,203,1436797,51.87,3436.06
1642,3828.020835,263,1437060,51.84,3436.06
1643,3731.370829,281,1437341,51.82,3430.29
1644,3695.156111,324,1437665,51.80,3430.29
1645,3732.085595,212,1437877,51.77,3430.29
1646,3761.155380,288,1438165,51.80,3430.29
1647,3783.062100,242,1438407,51.77,3430.29
1648,3826.203194,259,1438666,51.75,3430.29
1649,3715.549142,264,1438930,51.77,3431.42
1650,3829.164747,236,1439166,51.80,3431.42
1651,3768.181175,372,1439538,51.77,3431.42
1652,3752.014997,258,1439796,51.75,3431.42
1653,3793.854807,200,1439996,51.73,3431.42
1654,3810.312331,257,1440253,51.70,3431.42
1655,3791.976436,285,1440538,51.68,3431.42
1656,3915.419384,258,1440796,51.66,3431.42
1657,4034.712074,200,1440996,51.69,3431.42
1658,3999.334322,255,1441251,51.66,3431.42
1659,4068.832706,288,1441539,51.64,3431.42
1660,4059.442779,256,1441795,51.66,3431.42
1661,3988.854731,200,1441995,51.69,3431.42
1662,3972.348115,258,1442253,51.66,3431.42
1663,4005.622686,286,1442539,51.64,3431.42
1664,4017.463293,256,1442795,51.62,3431.42
1665,4016.218809,200,1442995,51.59,3431.42
1666,4044.144717,257,1443252,51.57,3431.42
1667,4091.563392,218,1443470,51.54,3431.42
1668,4034.601900,327,1443797,51.57,3431.42
1669,3968.845298,200,1443997,51.56,3431.42
1670,3987.104877,247,1444244,51.58,3431.42
1671,3874.039600,339,1444583,51.66,3431.42
1672,3928.985219,217,1444800,51.66,3431.42
1673,3991.808124,197,1444997,51.65,3431.42
1674,3900.857714,256,1445253,51.65,3431.42
1675,3940.105677,334,1445587,51.65,3442.06
1676,3953.290991,177,1445764,51.67,3442.76
1677,4022.285889,231,1445995,51.69,3442.76
1678,3974.519754,258,1446253,51.68,3442.76
1679,4131.916861,280,1446533,51.70,3442.76
1680,4275.449782,200,1446733,51.68,3442.76
1681,4313.041620,182,1446915,51.66,3442.76
1682,4403.858485,256,1447171,51.69,3442.76
1683,4378.162573,196,1447367,51.67,3442.76
1684,4407.100930,287,1447654,51.65,3442.76
1685,4409.048654,210,1447864,51.62,3442.76
1686,4541.403289,132,1447996,51.60,3442.76
1687,4653.062265,259,1448255,51.63,3442.76
1688,4623.732364,278,1448533,51.60,3442.76
1689,4612.568366,200,1448733,51.58,3442.76
1690,4735.539316,134,1448867,51.60,3442.76
1691,4694.471718,197,1449064,51.58,3442.76
1692,4712.987190,193,1449257,51.55,3442.76
1693,4858.503625,275,1449532,51.58,3443.47
1694,5039.679848,204,1449736,51.56,3443.47
1695,5001.830599,131,1449867,51.53,3443.47
1696,5062.555870,194,1450061,51.51,3443.47
1697,5040.636277,196,1450257,51.48,3443.47
1698,5075.054564,275,1450532,51.51,3458.53
1699,5086.056127,201,1450733,51.48,3458.53
1700,5143.415329,132,1450865,51.46,3458.53
1701,5804.927732,1,1450866,51.43,3458.53
1702,0.000000,0,1450866,51.40,3458.53
1703,7395.482574,1,1450867,51.38,3458.53
1704,0.000000,0,1450867,51.39,3459.93
1705,9200.743128,130,1450997,51.41,3459.93
1706,9195.017676,243,1451240,51.39,3459.93
1707,9177.945038,195,1451435,51.36,3459.93
1708,9176.483199,233,1451668,51.34,3459.93
1709,9157.726083,173,1451841,51.32,3459.93
1710,6183.321075,110,1451951,51.30,3459.93
1711,5559.138076,113,1452064,51.27,3459.93
1712,5922.053122,176,1452240,51.25,3459.93
1713,6221.751367,128,1452368,51.27,3459.93
1714,6446.879016,219,1452587,51.25,3459.93
1715,6583.664308,150,1452737,51.23,3459.93
1716,6597.223516,131,1452868,51.23,3459.93
1717,6850.249413,84,1452952,51.21,3459.93
1718,7225.635847,109,1453061,51.19,3459.93
1719,7426.691175,112,1453173,51.16,3459.93
1720,7547.186410,84,1453257,51.14,3459.93
1721,7626.034921,177,1453434,51.11,3459.93
1722,7615.026766,161,1453595,51.09,3459.93
1723,7678.637382,205,1453800,51.07,3459.93
1724,7596.571823,75,1453875,51.09,3459.93
1725,7671.236500,111,1453986,51.07,3459.93
1726,7609.953866,79,1454065,51.05,3459.93
1727,7592.634909,112,1454177,51.02,3459.93
1728,7628.740524,148,1454325,51.09,3467.06
1729,7554.816444,231,1454556,51.06,3467.06
1730,7287.787343,185,1454741,51.04,3467.06
1731,7231.489916,129,1454870,51.02,3467.06
1732,7263.302080,83,1454953,51.00,3467.06
1733,7290.587277,110,1455063,50.97,3467.06
1734,7329.697769,110,1455173,50.95,3467.06
1735,7331.148531,86,1455259,50.92,3467.06
1736,7338.753790,176,1455435,50.95,3467.06
1737,7385.761900,233,1455668,50.96,3467.06
1738,7359.829114,199,1455867,50.99,3467.06
1739,7397.823293,53,1455920,51.04,3472.16
1740,7371.008774,70,1455990,51.03,3472.16
1741,7440.167696,140,1456130,51.02,3472.16
1742,7399.756566,111,1456241,51.02,3472.34
1743,7400.150112,130,1456371,51.05,3472.51
1744,7429.128119,224,1456595,51.06,3472.51
1745,7586.155919,148,1456743,51.04,3472.51
1746,7656.904147,128,1456871,51.02,3472.51
1747,7674.349477,85,1456956,51.04,3472.51
1748,7588.182082,107,1457063,51.01,3472.51
1749,7584.899511,111,1457174,50.99,3472.51
1750,7668.907887,84,1457258,51.01,3472.51
1751,7664.759808,177,1457435,50.99,3472.51
1752,7688.127453,227,1457662,50.96,3472.51
1753,7663.310412,84,1457746,50.96,3472.51
1754,7742.857091,130,1457876,50.96,3472.51
1755,7722.204907,82,1457958,50.94,3472.51
1756,7809.696317,108,1458066,50.91,3472.51
1757,7767.783910,111,1458177,50.89,3472.51
1758,7752.658777,94,1458271,50.86,3472.51
1759,7811.329501,189,1458460,50.89,3472.51
1760,7845.519913,208,1458668,50.88,3472.51
1761,7837.959176,139,1458807,50.85,3472.51
1762,7857.770517,72,1458879,50.83,3472.51
1763,7921.461300,80,1458959,50.85,3472.51
1764,7996.706201,109,1459068,50.82,3472.51
1765,7992.797988,111,1459179,50.85,3484.58
1766,7911.264260,109,1459288,50.82,3484.58
1767,7929.968381,173,1459461,50.80,3484.58
1768,7918.043491,208,1459669,50.77,3484.58
1769,7977.244812,194,1459863,50.75,3484.58
1770,7927.286403,16,1459879,50.78,3484.58
1771,8043.249822,80,1459959,50.75,3484.58
1772,8036.766140,109,1460068,50.73,3484.58
1773,8097.399353,109,1460177,50.70,3484.58
1774,8064.789668,112,1460289,50.72,3484.58
1775,8041.276757,172,1460461,50.70,3484.58
1776,8049.173209,201,1460662,50.68,3484.58
1777,8100.300583,145,1460807,50.65,3484.58
1778,8091.767923,71,1460878,50.62,3484.58
1779,8132.214276,79,1460957,50.60,3484.58
1780,8221.702372,53,1461010,50.58,3484.58
1781,8244.890728,166,1461176,50.62,3484.58
1782,8171.364477,101,1461277,50.62,3484.58
1783,8229.927599,159,1461436,50.62,3484.58
1784,8274.644409,161,1461597,50.61,3484.58
1785,8427.924219,148,1461745,50.65,3484.76
1786,8389.575665,129,1461874,50.65,3484.76
1787,8298.902815,50,1461924,50.68,3484.76
1788,8346.291522,79,1462003,50.68,3484.76
1789,8280.649464,131,1462134,50.66,3484.76
1790,8363.551341,110,1462244,50.64,3484.76
1791,8415.504614,124,1462368,50.62,3484.76
1792,8408.476166,160,1462528,50.60,3484.76
1793,8438.081971,144,1462672,50.58,3484.76
1794,8498.250018,191,1462863,50.56,3484.76
1795,8431.277034,56,1462919,50.53,3484.76
1796,8462.699332,40,1462959,50.59,3484.76
1797,8404.679379,113,1463072,50.63,3485.99
1798,8411.768908,110,1463182,50.61,3485.99
1799,8306.089648,107,1463289,50.58,3485.99
1800,8336.835482,150,1463439,50.56,3485.99
1801,8403.039691,161,1463600,50.54,3485.99
1802,8320.631176,148,1463748,50.51,3485.99
1803,8349.763808,132,1463880,50.49,3485.99
1804,8287.408399,77,1463957,50.47,3485.99
1805,8294.910816,50,1464007,50.45,3485.99
1806,8260.683637,134,1464141,50.42,3485.99
1807,8230.402499,116,1464257,50.44,3485.99
1808,8251.218054,179,1464436,50.51,3499.22
1809,8163.391015,163,1464599,50.49,3499.22
1810,8144.223292,148,1464747,50.46,3499.22
1811,8213.460283,127,1464874,50.44,3499.22
1812,8152.345529,57,1464931,50.42,3499.22
1813,8147.131722,31,1464962,50.40,3499.22
1814,8517.187067,174,1465136,50.37,3499.22
1815,0.000000,0,1465136,50.35,3499.22
1816,8822.702007,155,1465291,50.33,3499.22
1817,0.000000,0,1465291,50.30,3499.22
1818,0.000000,0,1465291,50.31,3499.22
1819,0.000000,0,1465291,50.32,3499.22
1820,0.000000,0,1465291,50.32,3499.22
1821,11048.197747,668,1465959,50.30,3499.22
1822,0.000000,0,1465959,50.28,3499.22
1823,0.000000,0,1465959,50.25,3499.22
1824,0.000000,0,1465959,50.23,3499.22
1825,0.000000,0,1465959,50.20,3499.22
1826,0.000000,0,1465959,50.17,3499.22
1827,0.000000,0,1465959,50.15,3499.22
1828,0.000000,0,1465959,50.12,3499.22
1829,0.000000,0,1465959,50.09,3499.22
1830,0.000000,0,1465959,50.07,3499.22
1831,16480.123100,293,1466252,50.04,3499.22
1832,0.000000,0,1466252,50.02,3499.22
1833,0.000000,0,1466252,49.99,3499.22
1834,13676.662252,583,1466835,49.97,3499.22
1835,6434.493065,456,1467291,49.96,3499.22
1836,1622.861050,822,1468113,49.94,3499.22
1837,1273.479384,803,1468916,49.96,3499.22
1838,1396.712824,455,1469371,49.97,3499.22
1839,1437.491151,910,1470281,50.03,3499.22
1840,1347.014082,714,1470995,50.02,3499.22
1841,1385.184804,715,1471710,50.00,3499.22
1842,1455.781315,714,1472424,49.99,3499.22
1843,1536.269514,586,1473010,49.98,3499.22
1844,1464.159788,780,1473790,50.00,3499.22
1845,1316.577039,520,1474310,50.03,3499.22
1846,1470.539715,910,1475220,50.01,3499.22
1847,1294.169030,650,1475870,50.00,3499.84
1848,1533.531422,649,1476519,49.98,3499.84
1849,1791.422338,455,1476974,49.97,3499.84
1850,2136.938802,390,1477364,49.99,3499.84
1851,2343.268923,390,1477754,49.99,3499.84
1852,2480.223252,388,1478142,50.00,3499.84
1853,2318.278327,458,1478600,50.03,3499.84
1854,2441.263523,351,1478951,50.01,3499.84
1855,2516.034593,386,1479337,49.99,3499.84
1856,2838.638049,264,1479601,49.96,3499.84
1857,2948.410931,350,1479951,49.95,3499.84
1858,3054.577466,323,1480274,49.93,3499.84
1859,3041.698384,328,1480602,49.93,3499.84
1860,3105.126505,334,1480936,49.93,3499.84
1861,3060.837770,336,1481272,50.01,3499.84
1862,3167.183591,265,1481537,50.03,3499.84
1863,3153.931762,347,1481884,50.05,3499.84
1864,3281.358991,323,1482207,50.05,3499.84
1865,3287.170826,201,1482408,50.05,3499.84
1866,3313.431688,324,1482732,50.05,3499.84
1867,3372.341042,285,1483017,50.08,3500.01
1868,3421.348637,323,1483340,50.06,3500.01
1869,3512.005789,200,1483540,50.05,3500.01
1870,3682.757433,344,1483884,50.03,3500.01
1871,3797.837844,263,1484147,50.00,3500.01
1872,3754.042577,259,1484406,50.03,3500.01
1873,3756.162652,200,1484606,50.01,3500.01
1874,3766.216859,330,1484936,50.03,3500.01
1875,3741.919666,211,1485147,50.02,3500.01
1876,3881.970501,259,1485406,50.00,3500.01
1877,3896.833353,200,1485606,49.97,3505.49
1878,4008.337890,323,1485929,50.00,3527.94
1879,4141.508049,154,1486083,49.98,3527.94
1880,4165.398681,322,1486405,49.96,3527.94
1881,4203.757649,201,1486606,49.94,3527.94
1882,4208.921573,220,1486826,49.92,3527.94
1883,4244.771862,257,1487083,49.93,3527.94
1884,4136.603259,196,1487279,49.92,3527.94
1885,4158.545101,262,1487541,49.95,3527.94
1886,4177.238737,259,1487800,49.93,3527.94
1887,4142.379795,219,1488019,49.91,3527.94
1888,4244.053902,258,1488277,49.89,3527.94
1889,4342.885572,199,1488476,49.88,3527.94
1890,5093.887817,2,1488478,49.89,3527.94
1891,5638.812731,131,1488609,49.86,3527.94
1892,5627.683516,258,1488867,49.85,3527.94
1893,5715.792275,218,1489085,49.83,3527.94
1894,5831.369465,195,1489280,49.81,3527.94
1895,5847.049032,198,1489478,49.83,3527.94
1896,4696.447416,134,1489612,49.82,3527.94
1897,5072.236402,252,1489864,49.82,3527.94
1898,5355.771271,85,1489949,49.80,3527.94
1899,5749.201827,199,1490148,49.78,3527.94
1900,5705.278679,135,1490283,49.76,3527.94
1901,5875.143673,255,1490538,49.73,3527.94
1902,5831.742259,135,1490673,49.71,3527.94
1903,5855.707386,196,1490869,49.69,3527.94
1904,5813.210050,89,1490958,49.67,3527.94
1905,5773.740759,192,1491150,49.65,3527.94
1906,5830.223608,257,1491407,49.66,3527.94
1907,5875.460448,131,1491538,49.65,3527.94
1908,5878.150860,139,1491677,49.67,3527.94
1909,5771.700498,255,1491932,49.65,3527.94
1910,5770.063648,29,1491961,49.63,3527.94
1911,5745.434794,318,1492279,49.61,3527.94
1912,5775.933780,133,1492412,49.58,3527.94
1913,5724.320238,132,1492544,49.56,3527.94
1914,5770.159354,196,1492740,49.54,3527.94
1915,5760.625883,200,1492940,49.52,3527.94
1916,5688.899475,146,1493086,49.50,3527.94
1917,5713.668635,195,1493281,49.49,3527.94
1918,5726.201580,133,1493414,49.51,3527.94
1919,5717.346198,198,1493612,49.52,3527.94
1920,5663.898587,255,1493867,49.56,3527.94
1921,5690.408638,88,1493955,49.54,3527.94
1922,5624.072966,195,1494150,49.51,3527.94
1923,5650.617080,198,1494348,49.50,3527.94
1924,5653.781525,150,1494498,49.50,3527.94
1925,5553.878400,241,1494739,49.49,3527.94
1926,5548.896317,195,1494934,49.49,3527.94
1927,5520.381358,88,1495022,49.53,3527.94
1928,5568.523975,259,1495281,49.53,3527.94
1929,5572.860167,132,1495413,49.52,3527.94
1930,5523.436945,199,1495612,49.56,3527.94
1931,5436.181685,195,1495807,49.59,3527.94
1932,5613.264285,142,1495949,49.59,3527.94
1933,5614.257303,139,1496088,49.57,3527.94
1934,5691.744666,200,1496288,49.58,3527.94
1935,5638.263149,191,1496479,49.57,3527.94
1936,5731.105126,198,1496677,49.55,3527.94
1937,5723.506015,195,1496872,49.53,3527.94
1938,5709.495884,84,1496956,49.51,3527.94
1939,5814.966456,195,1497151,49.49,3527.94
1940,5815.652589,198,1497349,49.47,3527.94
1941,5796.397424,149,1497498,49.49,3527.94
1942,5836.135780,241,1497739,49.47,3527.94
1943,5886.992054,134,1497873,49.50,3527.94
1944,5953.747480,84,1497957,49.48,3527.94
1945,5892.114753,196,1498153,49.46,3527.94
1946,5887.120659,199,1498352,49.47,3533.95
1947,5959.937062,148,1498500,49.45,3533.95
1948,5963.515741,240,1498740,49.43,3533.95
1949,5949.191000,134,1498874,49.41,3533.95
1950,6020.021416,83,1498957,49.39,3533.95
1951,6074.612038,195,1499152,49.38,3533.95
1952,6105.382344,199,1499351,49.36,3533.95
1953,6093.613004,131,1499482,49.39,3533.95
1954,6153.601359,166,1499648,49.37,3533.95
1955,6200.463105,226,1499874,49.37,3533.95
1956,6144.894109,78,1499952,49.37,3533.95
1957,6157.331905,10,1499962,49.35,3533.95
1958,7207.759402,1,1499963,49.35,3533.95
1959,0.000000,0,1499963,49.34,3533.95
1960,8761.004944,255,1500218,49.32,3533.95
1961,8736.036473,194,1500412,49.30,3533.95
1962,8757.487335,132,1500544,49.28,3533.95
1963,8761.950997,197,1500741,49.25,3533.95
1964,8777.265557,134,1500875,49.24,3533.95
1965,8772.458514,85,1500960,49.26,3533.95
1966,6475.753645,129,1501089,49.24,3533.95
1967,6715.567353,131,1501220,49.26,3533.95
1968,7216.445756,69,1501289,49.24,3533.95
1969,7504.587864,130,1501419,49.22,3533.95
1970,7577.349417,194,1501613,49.20,3533.95
1971,7590.223560,194,1501807,49.18,3533.95
1972,7683.303708,134,1501941,49.15,3533.95
1973,7693.351355,24,1501965,49.13,3533.95
1974,7686.182774,187,1502152,49.12,3533.95
1975,7759.099860,73,1502225,49.09,3533.95
1976,7769.725080,126,1502351,49.12,3533.95
1977,7812.416559,131,1502482,49.10,3533.95
1978,7799.416920,136,1502618,49.08,3533.95
1979,7803.141750,193,1502811,49.11,3533.95
1980,7780.487769,131,1502942,49.09,3533.95
1981,7789.976962,81,1503023,49.07,3533.95
1982,7819.323130,133,1503156,49.05,3533.95
1983,7739.845935,115,1503271,49.03,3533.95
1984,7824.232708,83,1503354,49.01,3533.95
1985,7812.100273,148,1503502,48.99,3533.95
1986,7810.219289,117,1503619,48.97,3533.95
1987,7811.409944,202,1503821,48.95,3533.95
1988,7852.355701,134,1503955,48.97,3533.95
1989,7731.599074,120,1504075,48.99,3533.95
1990,7706.420278,87,1504162,49.00,3533.95
1991,7808.355280,123,1504285,48.99,3533.95
1992,7786.474653,130,1504415,48.97,3533.95
1993,7832.146185,91,1504506,48.95,3533.95
1994,7797.263122,237,1504743,48.94,3533.95
1995,7718.119233,135,1504878,48.91,3533.95
1996,7774.526748,83,1504961,48.89,3533.95
1997,7767.699069,123,1505084,48.87,3533.95
1998,7847.015480,139,1505223,48.85,3533.95
1999,7844.425800,65,1505288,48.83,3533.95
2000,7783.237112,129,1505417,48.86,3533.95
2001,7729.985434,198,1505615,48.88,3535.18
2002,7729.405206,191,1505806,48.90,3535.18
2003,7715.456117,77,1505883,48.89,3535.18
2004,7712.259532,83,1505966,48.89,3535.18
2005,7823.740178,128,1506094,48.89,3535.18
2006,7788.418891,132,1506226,48.88,3535.18
2007,7824.901844,69,1506295,48.91,3535.18
2008,7816.221877,132,1506427,48.92,3535.18
2009,7854.803298,188,1506615,48.92,3535.18
2010,7941.799270,194,1506809,48.92,3535.18
2011,7867.656946,134,1506943,48.91,3535.18
2012,7827.929624,27,1506970,48.90,3535.18
2013,7910.538825,125,1507095,48.91,3535.88
2014,7896.353400,132,1507227,48.93,3535.88
2015,7765.643831,69,1507296,48.96,3535.88
2016,7865.714644,196,1507492,48.94,3535.88
2017,7856.574677,128,1507620,48.93,3535.88
2018,7899.428937,192,1507812,48.93,3535.88
2019,7825.566308,141,1507953,48.93,3535.88
2020,7736.177180,46,1507999,48.92,3535.88
2021,7731.360973,161,1508160,48.95,3535.88
2022,7603.067448,128,1508288,48.96,3535.88
2023,7573.799915,128,1508416,48.95,3535.88
2024,7534.172696,91,1508507,48.99,3535.88
2025,7582.935412,177,1508684,48.99,3535.88
2026,7556.483553,196,1508880,48.97,3536.65
2027,7649.725880,85,1508965,48.99,3554.27
2028,7621.939321,130,1509095,48.97,3554.27
2029,7502.934161,131,1509226,48.99,3554.27
2030,7500.403816,70,1509296,48.97,3554.27
2031,7543.785910,131,1509427,48.96,3554.27
2032,7532.863743,189,1509616,48.94,3554.27
2033,7743.742145,194,1509810,48.92,3554.27
2034,0.000000,0,1509810,48.90,3554.27
2035,8356.131876,155,1509965,48.88,3554.27
2036,0.000000,0,1509965,48.90,3554.27
2037,8602.254449,266,1510231,48.87,3554.27
2038,0.000000,0,1510231,48.86,3554.27
2039,0.000000,0,1510231,48.84,3554.27
2040,0.000000,0,1510231,48.81,3554.27
2041,0.000000,0,1510231,48.84,3556.40
2042,0.000000,0,1510231,48.82,3556.40
2043,0.000000,0,1510231,48.79,3556.40
2044,0.000000,0,1510231,48.77,3556.40
2045,12357.806269,626,1510857,48.76,3556.40
2046,0.000000,0,1510857,48.73,3556.40
2047,0.000000,0,1510857,48.71,3556.40
2048,0.000000,0,1510857,48.68,3556.40
2049,0.000000,0,1510857,48.66,3556.40
2050,0.000000,0,1510857,48.64,3556.40
2051,0.000000,0,1510857,48.62,3556.40
2052,0.000000,0,1510857,48.60,3556.40
2053,0.000000,0,1510857,48.57,3556.40
2054,13684.518657,713,1511570,48.55,3556.40
2055,5329.717566,649,1512219,48.54,3556.40
2056,1403.119241,714,1512933,48.53,3556.40
2057,1495.822279,651,1513584,48.55,3556.40
2058,1903.283934,585,1514169,48.53,3556.40
2059,1293.042588,628,1514797,48.56,3556.40
2060,1266.670202,866,1515663,48.55,3556.40
2061,1330.133339,715,1516378,48.53,3556.40
2062,1557.999949,780,1517158,48.52,3556.40
2063,1301.330277,715,1517873,48.53,3556.40
2064,1499.301566,520,1518393,48.53,3556.40
2065,1433.253421,715,1519108,48.52,3556.40
2066,1415.756237,779,1519887,48.50,3556.40
2067,1377.980859,715,1520602,48.49,3556.40
2068,1477.471701,714,1521316,48.47,3556.40
2069,1493.600199,598,1521914,48.46,3556.40
2070,1717.852703,442,1522356,48.53,3556.40
2071,2147.402682,390,1522746,48.52,3556.40
2072,2508.539907,325,1523071,48.54,3556.40
2073,2768.357269,390,1523461,48.52,3556.40
2074,2778.291920,326,1523787,48.50,3556.40
2075,2944.615996,349,1524136,48.49,3556.40
2076,2911.676093,390,1524526,48.47,3556.40
2077,2840.457797,286,1524812,48.46,3556.40
2078,2832.865894,326,1525138,48.44,3556.40
2079,2817.296060,325,1525463,48.42,3556.66
2080,2964.416736,352,1525815,48.41,3556.66
2081,3031.208774,389,1526204,48.41,3556.66
2082,2897.505515,325,1526529,48.45,3556.66
2083,2973.111533,287,1526816,48.48,3556.66
2084,2985.062670,323,1527139,48.46,3556.66
2085,3105.970645,390,1527529,48.46,3556.66
2086,3020.218964,287,1527816,48.46,3556.66
2087,3128.572241,261,1528077,48.46,3556.66
2088,3129.070024,353,1528430,48.46,3556.66
2089,3263.497449,358,1528788,48.50,3556.66
2090,3222.910066,224,1529012,48.50,3556.66
2091,3274.880994,261,1529273,48.49,3556.66
2092,3458.624421,261,1529534,48.49,3556.66
2093,3612.410915,284,1529818,48.53,3556.66
2094,3736.235383,260,1530078,48.56,3556.66
2095,3739.916200,312,1530390,48.54,3556.66
2096,3893.628451,209,1530599,48.56,3556.66
2097,3927.005359,283,1530882,48.55,3556.66
2098,3935.086489,261,1531143,48.53,3556.66
2099,3999.695731,257,1531400,48.52,3556.66
2100,3968.004223,199,1531599,48.50,3556.66
2101,4047.243578,219,1531818,48.48,3556.66
2102,4130.932081,198,1532016,48.46,3556.66
2103,4169.113556,258,1532274,48.45,3556.66
2104,4258.853729,259,1532533,48.43,3556.66
2105,4299.651712,199,1532732,48.46,3556.66
2106,4345.159700,221,1532953,48.48,3556.66
2107,4318.608250,260,1533213,48.46,3556.66
2108,4390.803197,278,1533491,48.48,3573.76
2109,4438.700613,177,1533668,48.46,3573.76
2110,4484.244320,215,1533883,48.44,3573.76
2111,4528.517598,199,1534082,48.42,3573.76
2112,4557.522069,195,1534277,48.41,3573.76
2113,4540.639511,257,1534534,48.39,3573.76
2114,4539.942715,199,1534733,48.38,3573.76
2115,4511.272869,221,1534954,48.36,3573.76
2116,4603.672658,192,1535146,48.35,3573.76
2117,5390.334368,62,1535208,48.40,3573.76
2118,0.000000,0,1535208,48.38,3573.76
2119,7416.733412,1,1535209,48.36,3573.76
2120,0.000000,0,1535209,48.34,3573.76
2121,8546.734547,239,1535448,48.32,3573.76
2122,8514.440119,220,1535668,48.30,3573.76
2123,8497.254691,215,1535883,48.28,3573.76
2124,8461.501416,136,1536019,48.27,3573.76
2125,8257.384195,195,1536214,48.25,3573.76
2126,5093.524518,132,1536346,48.23,3573.76
2127,5399.921820,163,1536509,48.21,3573.76
2128,5869.994594,161,1536670,48.19,3573.76
2129,6020.460830,149,1536819,48.26,3573.76
2130,6222.685503,164,1536983,48.25,3573.76
2131,6401.522791,167,1537150,48.22,3573.76
2132,6625.050247,124,1537274,48.20,3573.76
2133,6959.150087,71,1537345,48.18,3573.76
2134,7286.015214,147,1537492,48.16,3573.76
2135,7489.161309,49,1537541,48.14,3573.76
2136,7407.085401,255,1537796,48.13,3573.76
2137,7446.575645,97,1537893,48.11,3573.76
2138,7401.757329,194,1538087,48.09,3573.76
2139,7388.336043,126,1538213,48.07,3573.76
2140,7385.765404,70,1538283,48.07,3573.93
2141,7404.689119,166,1538449,48.16,3573.93
2142,7352.307328,62,1538511,48.14,3573.93
2143,7301.291643,203,1538714,48.12,3573.93
2144,7334.153660,175,1538889,48.11,3573.93
2145,7315.070893,132,1539021,48.09,3573.93
2146,7316.231643,192,1539213,48.07,3573.93
2147,7030.823985,68,1539281,48.05,3573.93
2148,7029.532816,152,1539433,48.03,3573.93
2149,7048.645083,79,1539512,48.03,3573.93
2150,7107.366930,193,1539705,48.03,3573.93
2151,7153.056579,116,1539821,48.07,3573.93
2152,7198.427833,164,1539985,48.10,3573.93
2153,7171.255931,226,1540211,48.15,3573.93
2154,7131.160985,70,1540281,48.14,3573.93
2155,7165.278497,130,1540411,48.14,3573.93
2156,7166.132727,98,1540509,48.14,3573.93
2157,7125.731278,161,1540670,48.18,3574.11
2158,7184.289966,131,1540801,48.17,3574.11
2159,7241.447215,156,1540957,48.15,3574.11
2160,7219.234778,191,1541148,48.13,3574.11
2161,7216.859351,130,1541278,48.12,3574.11
2162,7207.954511,70,1541348,48.10,3574.11
2163,7302.585152,153,1541501,48.08,3574.11
2164,7339.672617,105,1541606,48.09,3574.11
2165,7344.146564,134,1541740,48.13,3574.11
2166,7394.556249,154,1541894,48.11,3574.11
2167,7353.276648,194,1542088,48.09,3574.11
2168,7345.087720,185,1542273,48.11,3575.32
2169,7292.326388,16,1542289,48.09,3576.68
2170,7334.664701,162,1542451,48.08,3576.68
2171,7384.292008,90,1542541,48.06,3576.68
2172,7388.775696,173,1542714,48.04,3576.68
2173,7408.577656,110,1542824,48.02,3576.68
2174,7390.001925,161,1542985,48.00,3576.68
2175,7419.306947,167,1543152,47.99,3576.68
2176,7387.753667,131,1543283,48.01,3576.68
2177,7380.969516,71,1543354,48.03,3576.68
2178,7447.313630,153,1543507,48.01,3576.68
2179,7472.046491,100,1543607,47.99,3576.68
2180,7516.593952,190,1543797,48.00,3583.83
2181,7478.942991,159,1543956,48.00,3583.83
2182,7480.393399,133,1544089,47.98,3583.83
2183,7493.868964,187,1544276,47.96,3583.83
2184,7459.849913,15,1544291,47.94,3583.83
2185,7535.246715,164,1544455,47.92,3583.83
2186,7517.923926,65,1544520,47.91,3583.83
2187,7522.276975,181,1544701,47.89,3583.83
2188,7559.966643,123,1544824,47.91,3583.83
2189,7554.239481,162,1544986,47.93,3583.83
2190,7502.593795,227,1545213,47.91,3583.83
2191,7548.031643,73,1545286,47.90,3583.83
2192,7547.868746,67,1545353,47.87,3583.83
2193,7601.190910,143,1545496,47.85,3583.83
2194,7590.050926,111,1545607,47.83,3583.83
2195,7537.251553,136,1545743,47.81,3583.83
2196,7553.682381,157,1545900,47.80,3583.83
2197,7599.967461,127,1546027,47.78,3583.83
2198,7600.099385,190,1546217,47.76,3583.83
2199,7670.627519,74,1546291,47.74,3583.83
2200,7701.266510,158,1546449,47.76,3583.83
2201,7618.577576,65,1546514,47.79,3583.83
2202,7638.099691,163,1546677,47.77,3583.83
2203,7617.772216,131,1546808,47.75,3583.83
2204,7690.696305,152,1546960,47.74,3583.83
2205,7693.456393,188,1547148,47.72,3583.83
2206,7690.116004,130,1547278,47.70,3583.83
2207,7689.946452,71,1547349,47.68,3583.83
2208,7720.175442,107,1547456,47.67,3583.83
2209,7760.351142,90,1547546,47.65,3583.83
2210,7748.269156,156,1547702,47.63,3583.83
2211,7814.931224,107,1547809,47.62,3583.83
2212,7899.071430,156,1547965,47.63,3583.83
2213,7808.748805,188,1548153,47.70,3583.83
2214,7778.203278,129,1548282,47.69,3583.83
2215,7767.031889,69,1548351,47.67,3583.83
2216,7905.426007,106,1548457,47.65,3583.83
2217,7944.699837,66,1548523,47.64,3583.83
2218,7964.563230,180,1548703,47.62,3583.83
2219,7941.335851,122,1548825,47.60,3583.83
2220,7951.651433,161,1548986,47.58,3583.83
2221,7982.776381,166,1549152,47.57,3583.83
2222,7993.666544,130,1549282,47.55,3583.83
2223,8031.519645,69,1549351,47.54,3583.83
2224,8039.001964,102,1549453,47.56,3583.83
2225,8051.195511,72,1549525,47.61,3583.83
2226,8056.055925,178,1549703,47.60,3583.83
2227,8089.821494,106,1549809,47.58,3583.83
2228,8067.789980,177,1549986,47.56,3583.83
2229,8145.501485,166,1550152,47.55,3583.83
2230,8114.301685,129,1550281,47.53,3583.83
2231,8112.055699,68,1550349,47.51,3583.83
2232,8111.002843,102,1550451,47.50,3583.83
2233,8151.241900,66,1550517,47.48,3583.83
2234,8184.658140,162,1550679,47.46,3583.83
2235,8192.715250,127,1550806,47.44,3583.83
2236,8247.231530,97,1550903,47.46,3583.83
2237,8287.718549,189,1551092,47.52,3583.83
2238,8220.677950,184,1551276,47.52,3583.83
2239,8142.409386,23,1551299,47.52,3583.83
2240,8236.812693,124,1551423,47.52,3583.83
2241,8228.789485,91,1551514,47.51,3584.04
2242,8287.184639,159,1551673,47.51,3584.13
2243,8275.303858,130,1551803,47.53,3584.30
2244,8285.654579,91,1551894,47.54,3584.30
2245,8246.780454,133,1552027,47.54,3584.30
2246,8295.599782,191,1552218,47.54,3584.30
2247,8377.662324,76,1552294,47.52,3584.30
2248,8270.283709,64,1552358,47.54,3584.30
2249,8370.455723,105,1552463,47.56,3584.30
2250,8333.037677,86,1552549,47.55,3584.30
2251,8286.428966,191,1552740,47.53,3584.30
2252,8334.495838,87,1552827,47.51,3584.30
2253,8363.930835,162,1552989,47.54,3584.30
2254,8345.401698,166,1553155,47.53,3584.30
2255,8342.925938,136,1553291,47.51,3584.30
2256,8185.254141,64,1553355,47.49,3584.30
2257,8286.296186,100,1553455,47.47,3584.30
2258,8301.053682,63,1553518,47.46,3584.30
2259,8216.789386,162,1553680,47.44,3584.30
2260,8198.712986,130,1553810,47.46,3584.30
2261,8199.702651,160,1553970,47.48,3584.30
2262,8152.445057,182,1554152,47.46,3584.30
2263,8197.735204,136,1554288,47.44,3584.30
2264,8219.643975,64,1554352,47.43,3587.07
2265,8095.851654,100,1554452,47.45,3601.04
2266,8087.997882,67,1554519,47.44,3601.04
2267,8078.990284,161,1554680,47.42,3601.04
2268,0.000000,0,1554680,47.40,3601.04
2269,0.000000,0,1554680,47.38,3601.04
2270,0.000000,0,1554680,47.36,3601.04
2271,0.000000,0,1554680,47.35,3601.04
2272,10545.956261,675,1555355,47.36,3601.04
2273,0.000000,0,1555355,47.39,3601.04
2274,0.000000,0,1555355,47.37,3601.04
2275,0.000000,0,1555355,47.35,3601.04
2276,0.000000,0,1555355,47.34,3601.04
2277,10105.638767,390,1555745,47.32,3601.04
2278,0.000000,0,1555745,47.30,3601.04
2279,0.000000,0,1555745,47.28,3601.04
2280,0.000000,0,1555745,47.26,3601.04
2281,0.000000,0,1555745,47.24,3601.04
2282,0.000000,0,1555745,47.21,3601.04
2283,0.000000,0,1555745,47.20,3601.04
2284,0.000000,0,1555745,47.19,3601.04
2285,12212.610838,130,1555875,47.17,3601.04
2286,0.000000,0,1555875,47.15,3601.04
2287,15059.992032,65,1555940,47.13,3601.04
2288,0.000000,0,1555940,47.11,3601.04
2289,16951.451185,129,1556069,47.09,3601.04
2290,14743.646618,650,1556719,47.07,3601.04
2291,2755.615740,778,1557497,47.06,3601.04
2292,1463.708745,714,1558211,47.05,3601.04
2293,1468.253581,457,1558668,47.04,3601.04
2294,1513.019103,908,1559576,47.11,3601.04
2295,1314.042195,714,1560290,47.10,3601.04
2296,1471.987838,594,1560884,47.09,3601.04
2297,1519.317648,837,1561721,47.08,3601.04
2298,1346.479378,585,1562306,47.11,3601.04
2299,1298.554746,714,1563020,47.09,3601.04
2300,1451.315633,730,1563750,47.09,3601.04
2301,1423.506930,700,1564450,47.15,3601.04
2302,1499.077879,774,1565224,47.14,3601.04
2303,1411.053970,527,1565751,47.13,3601.04
2304,1494.413843,845,1566596,47.12,3601.04
2305,1320.817271,650,1567246,47.11,3601.04
2306,1390.641534,780,1568026,47.09,3601.04
2307,1545.541667,338,1568364,47.12,3601.04
2308,1971.652137,504,1568868,47.14,3601.04
2309,2206.966114,520,1569388,47.17,3601.04
2310,2155.917267,391,1569779,47.16,3601.04
2311,2334.291691,390,1570169,47.15,3601.04
2312,2536.321086,287,1570456,47.13,3601.04
2313,2724.915838,389,1570845,47.12,3601.22
2314,2770.547481,389,1571234,47.11,3601.22
2315,2846.709122,223,1571457,47.09,3601.22
2316,3082.088765,324,1571781,47.08,3601.22
2317,3115.761022,389,1572170,47.06,3601.22
2318,3122.947502,285,1572455,47.05,3601.22
2319,3202.000570,261,1572716,47.07,3601.22
2320,3274.296571,266,1572982,47.11,3601.22
2321,3464.630390,383,1573365,47.12,3601.22
2322,3398.300919,224,1573589,47.10,3601.22
2323,3313.747507,385,1573974,47.09,3601.22
2324,3360.469139,264,1574238,47.07,3601.22
2325,3379.568669,223,1574461,47.06,3601.22
2326,3307.496783,412,1574873,47.05,3601.22
2327,3262.180445,297,1575170,47.03,3601.22
2328,3244.100447,285,1575455,47.02,3601.22
2329,3259.110907,376,1575831,47.00,3601.22
2330,3250.293389,216,1576047,46.99,3601.22
2331,3295.668835,319,1576366,47.01,3601.22
2332,3351.795258,287,1576653,47.07,3601.22
2333,3329.815615,326,1576979,47.08,3601.22
2334,3284.795041,262,1577241,47.08,3601.22
2335,3355.802506,282,1577523,47.08,3601.22
2336,3346.958419,370,1577893,47.08,3601.22
2337,3396.206089,285,1578178,47.09,3601.39
2338,3391.103692,246,1578424,47.12,3601.39
2339,3437.132977,354,1578778,47.12,3601.39
2340,3421.899725,266,1579044,47.12,3601.39
2341,3441.989295,262,1579306,47.12,3601.39
2342,3652.670945,218,1579524,47.10,3601.39
2343,3652.098247,257,1579781,47.09,3601.39
2344,3872.570939,315,1580096,47.15,3601.39
2345,3907.874155,212,1580308,47.14,3601.39
2346,3902.329800,216,1580524,47.16,3601.39
2347,3885.602401,313,1580837,47.15,3601.39
2348,3899.203346,272,1581109,47.13,3601.39
2349,3990.045174,201,1581310,47.12,3601.39
2350,4061.034862,215,1581525,47.11,3601.39
2351,4080.048188,312,1581837,47.09,3601.39
2352,4071.211602,259,1582096,47.07,3601.39
2353,4090.635546,149,1582245,47.06,3601.39
2354,4168.022882,214,1582459,47.04,3601.39
2355,4179.302333,263,1582722,47.03,3601.39
2356,4363.580851,322,1583044,47.09,3601.39
2357,4384.503485,196,1583240,47.08,3606.54
2358,4332.244287,132,1583372,47.10,3626.64
2359,4394.483133,219,1583591,47.09,3626.64
2360,4458.891565,291,1583882,47.07,3626.64
2361,4528.469579,228,1584110,47.05,3626.64
2362,4550.892634,136,1584246,47.04,3626.64
2363,4653.961290,180,1584426,47.03,3626.64
2364,4853.941366,230,1584656,47.01,3626.64
2365,4848.522960,253,1584909,46.99,3626.64
2366,4820.070108,203,1585112,46.97,3626.64
2367,4778.660006,201,1585313,46.96,3626.64
2368,4753.945605,148,1585461,46.99,3626.64
2369,4719.341371,261,1585722,47.01,3626.64
2370,4667.693936,315,1586037,46.99,3626.64
2371,4658.650502,204,1586241,46.98,3626.64
2372,4609.838189,133,1586374,46.96,3626.64
2373,4572.063644,216,1586590,46.94,3626.64
2374,4544.910372,250,1586840,46.93,3626.64
2375,4504.425291,272,1587112,46.91,3626.64
2376,4454.430718,201,1587313,46.90,3626.64
2377,4494.180423,115,1587428,46.88,3626.64
2378,4481.322599,294,1587722,46.86,3626.64
2379,4381.302850,316,1588038,46.85,3626.64
2380,4460.122428,207,1588245,46.87,3626.64
2381,4366.668033,133,1588378,46.89,3626.64
2382,4403.524766,216,1588594,46.88,3626.64
2383,4395.755659,290,1588884,46.86,3626.64
2384,4403.773750,295,1589179,46.85,3626.64
2385,4372.087482,196,1589375,46.83,3626.64
2386,4320.137861,152,1589527,46.81,3626.64
2387,4407.540416,261,1589788,46.80,3626.64
2388,4445.090558,253,1590041,46.79,3626.64
2389,4314.637971,273,1590314,46.77,3626.64
2390,4332.645670,115,1590429,46.76,3626.72
2391,4307.233968,233,1590662,46.74,3626.72
2392,4381.669471,251,1590913,46.81,3626.72
2393,4363.132983,330,1591243,46.85,3626.72
2394,4298.849449,138,1591381,46.85,3626.72
2395,4299.799012,215,1591596,46.84,3626.72
2396,4285.482202,315,1591911,46.85,3626.72
2397,4243.373205,255,1592166,46.85,3626.72
2398,4345.585267,155,1592321,46.86,3626.81
2399,4303.265557,208,1592529,46.89,3626.81
2400,4344.948750,261,1592790,46.89,3626.81
2401,4447.792642,251,1593041,46.89,3626.81
2402,4562.129071,203,1593244,46.88,3626.81
2403,4623.153780,184,1593428,46.90,3626.81
2404,4636.115315,169,1593597,46.89,3626.81
2405,4743.040349,287,1593884,46.90,3626.81
2406,4673.647122,218,1594102,46.90,3626.81
2407,4753.388114,210,1594312,46.88,3626.81
2408,4695.800687,183,1594495,46.91,3626.81
2409,4710.107824,168,1594663,46.89,3626.81
2410,4739.820745,222,1594885,46.88,3626.81
2411,4895.015728,281,1595166,46.86,3626.81
2412,4909.635651,148,1595314,46.85,3626.81
2413,4980.439168,181,1595495,46.83,3626.81
2414,5007.940435,168,1595663,46.82,3626.81
2415,5087.604411,222,1595885,46.81,3626.81
2416,5043.686936,219,1596104,46.82,3627.49
2417,5082.071893,207,1596311,46.81,3627.49
2418,5129.403986,121,1596432,46.83,3627.49
2419,5207.236287,167,1596599,46.82,3640.71
2420,5177.344786,258,1596857,46.84,3656.21
2421,5136.788809,244,1597101,46.82,3656.21
2422,5238.668022,146,1597247,46.80,3656.21
2423,5272.244329,139,1597386,46.79,3656.21
2424,5282.643836,210,1597596,46.78,3656.21
2425,5277.526610,197,1597793,46.76,3656.21
2426,5990.969222,64,1597857,46.74,3656.21
2427,0.000000,0,1597857,46.73,3656.21
2428,7505.117067,4,1597861,46.74,3656.21
2429,8073.724637,240,1598101,46.73,3656.21
2430,8078.998166,85,1598186,46.71,3656.21
2431,8091.510722,196,1598382,46.70,3656.21
2432,8090.491414,154,1598536,46.72,3656.21
2433,8099.862101,253,1598789,46.70,3656.21
2434,6896.212528,101,1598890,46.69,3656.21
2435,5843.448475,152,1599042,46.68,3656.21
2436,6128.317939,131,1599173,46.66,3656.21
2437,6518.397519,140,1599313,46.64,3656.21
2438,6632.124177,75,1599388,46.63,3656.21
2439,6949.128377,148,1599536,46.61,3656.21
2440,7172.496192,131,1599667,46.63,3656.21
2441,7462.967140,190,1599857,46.61,3656.21
2442,7734.517795,119,1599976,46.62,3656.21
2443,7782.890333,127,1600103,46.62,3656.21
2444,7740.480253,82,1600185,46.61,3656.21
2445,7745.961999,133,1600318,46.59,3656.21
2446,7786.260016,115,1600433,46.57,3656.21
2447,7821.647390,105,1600538,46.56,3656.21
2448,7874.211558,192,1600730,46.54,3656.21
2449,7893.014180,128,1600858,46.53,3656.21
2450,7847.399505,120,1600978,46.51,3656.21
2451,7862.258359,127,1601105,46.49,3656.21
2452,7834.951775,82,1601187,46.51,3656.98
2453,7825.674522,134,1601321,46.52,3656.98
2454,7827.630478,113,1601434,46.59,3656.98
2455,7917.815560,163,1601597,46.59,3656.98
2456,7954.994851,134,1601731,46.59,3656.98
2457,7751.725834,160,1601891,46.59,3656.98
2458,7476.188133,152,1602043,46.59,3656.98
2459,7436.017300,130,1602173,46.58,3656.98
2460,7436.910312,140,1602313,46.62,3657.06
2461,7473.354354,76,1602389,46.62,3657.06
2462,7492.374778,113,1602502,46.62,3657.06
2463,7479.882057,163,1602665,46.60,3657.06
2464,7558.413101,129,1602794,46.59,3657.06
2465,7614.796223,159,1602953,46.61,3657.06
2466,7545.959517,152,1603105,46.63,3657.06
2467,7534.089045,84,1603189,46.61,3657.06
2468,7591.882984,132,1603321,46.60,3657.06
2469,7549.152352,116,1603437,46.58,3657.06
2470,7468.387582,160,1603597,46.56,3657.06
2471,7449.955723,135,1603732,46.59,3657.06
2472,7451.826208,159,1603891,46.57,3657.06
2473,7346.701818,156,1604047,46.56,3657.06
2474,7398.505008,128,1604175,46.54,3657.06
2475,7429.907331,138,1604313,46.53,3657.06
2476,7347.496033,119,1604432,46.51,3657.06
2477,7308.379146,106,1604538,46.53,3657.06
2478,7251.296400,129,1604667,46.52,3657.06
2479,7279.459619,197,1604864,46.54,3657.06
2480,7237.063923,180,1605044,46.52,3657.06
2481,7232.654754,129,1605173,46.51,3657.06
2482,7147.073824,80,1605253,46.50,3657.06
2483,7218.057923,130,1605383,46.48,3669.09
2484,7438.508421,120,1605503,46.50,3673.16
2485,0.000000,0,1605503,46.48,3673.42
2486,0.000000,0,1605503,46.47,3673.42
2487,0.000000,0,1605503,46.45,3673.42
2488,0.000000,0,1605503,46.43,3673.42
2489,0.000000,0,1605503,46.43,3673.42
2490,10010.513642,818,1606321,46.44,3673.42
2491,0.000000,0,1606321,46.43,3673.42
2492,0.000000,0,1606321,46.41,3673.42
2493,0.000000,0,1606321,46.39,3673.42
2494,0.000000,0,1606321,46.41,3673.42
2495,10918.120962,191,1606512,46.39,3673.42
2496,0.000000,0,1606512,46.37,3673.42
2497,0.000000,0,1606512,46.35,3673.42
2498,8137.711656,65,1606577,46.34,3673.42
2499,0.000000,0,1606577,46.32,3673.42
2500,0.000000,0,1606577,46.30,3673.42
2501,0.000000,0,1606577,46.28,3673.42
2502,0.000000,0,1606577,46.26,3673.42
2503,0.000000,0,1606577,46.25,3673.42
2504,0.000000,0,1606577,46.23,3673.42
2505,0.000000,0,1606577,46.21,3673.42
2506,15964.467430,520,1607097,46.20,3673.42
2507,8310.576151,844,1607941,46.19,3673.42
2508,1487.907221,714,1608655,46.18,3673.42
2509,1393.491569,715,1609370,46.17,3673.42
2510,1429.087602,716,1610086,46.16,3673.42
2511,1454.655674,650,1610736,46.17,3673.42
2512,1470.230701,584,1611320,46.20,3673.42
2513,1384.167806,780,1612100,46.21,3673.42
2514,1413.440799,779,1612879,46.20,3673.42
2515,1379.423184,521,1613400,46.19,3673.42
2516,1539.247233,844,1614244,46.18,3673.42
2517,1326.086544,715,1614959,46.21,3673.42
2518,1412.087311,714,1615673,46.21,3673.42
2519,1462.151809,649,1616322,46.25,3673.42
2520,1404.389109,779,1617101,46.27,3673.42
2521,1404.791601,651,1617752,46.26,3673.42
2522,1522.710517,715,1618467,46.25,3673.42
2523,1508.271828,585,1619052,46.23,3673.42
2524,1379.893724,845,1619897,46.22,3673.42
2525,1398.111990,454,1620351,46.22,3673.42
2526,1915.277671,326,1620677,46.24,3673.42
2527,2502.241804,389,1621066,46.26,3673.50
2528,2625.282474,390,1621456,46.27,3673.50
2529,2402.478461,465,1621921,46.27,3673.50
2530,2277.895456,408,1622329,46.26,3673.50
2531,2517.065884,388,1622717,46.25,3673.50
2532,2624.815998,398,1623115,46.24,3673.50
2533,2699.324513,279,1623394,46.22,3673.50
2534,2759.024588,325,1623719,46.21,3673.50
2535,2908.036346,332,1624051,46.20,3673.50
2536,2993.442828,406,1624457,46.19,3673.50
2537,3055.063911,230,1624687,46.17,3673.50
2538,3150.907666,303,1624990,46.19,3673.50
2539,3288.336041,338,1625328,46.20,3673.50
2540,3277.759561,330,1625658,46.21,3673.59
2541,3174.788741,267,1625925,46.23,3673.59
2542,3238.826940,371,1626296,46.22,3673.59
2543,3299.215776,292,1626588,46.20,3673.59
2544,3464.419919,261,1626849,46.19,3673.59
2545,3511.796811,206,1627055,46.18,3673.59
2546,3551.003778,339,1627394,46.16,3673.59
2547,3713.969777,198,1627592,46.15,3673.59
2548,3672.253722,324,1627916,46.15,3673.59
2549,3645.513509,250,1628166,46.15,3673.59
2550,3687.754004,269,1628435,46.22,3673.59
2551,3742.433124,253,1628688,46.22,3673.59
2552,3832.569537,239,1628927,46.22,3673.59
2553,3826.751700,304,1629231,46.26,3673.59
2554,3903.091383,205,1629436,46.27,3673.59
2555,3844.899219,287,1629723,46.28,3673.59
2556,3818.084751,270,1629993,46.33,3673.68
2557,3849.100229,291,1630284,46.34,3673.68
2558,3885.516514,217,1630501,46.37,3673.68
2559,3875.738994,287,1630788,46.38,3673.68
2560,3891.791509,206,1630994,46.38,3673.68
2561,4010.773529,238,1631232,46.37,3673.68
2562,4072.446355,207,1631439,46.38,3673.68
2563,4130.375220,284,1631723,46.36,3673.68
2564,4146.389863,270,1631993,46.35,3673.68
2565,4231.027856,175,1632168,46.36,3673.68
2566,4241.157834,231,1632399,46.40,3673.68
2567,4311.264674,194,1632593,46.40,3673.68
2568,4334.157564,324,1632917,46.41,3676.65
2569,4314.880948,207,1633124,46.39,3676.65
2570,4403.136705,208,1633332,46.38,3676.65
2571,4462.785060,172,1633504,46.37,3676.65
2572,4521.943733,286,1633790,46.35,3676.65
2573,4483.527765,205,1633995,46.34,3676.65
2574,4459.014603,237,1634232,46.33,3676.65
2575,4462.864414,167,1634399,46.31,3676.65
2576,4465.041735,196,1634595,46.30,3676.65
2577,4514.742526,322,1634917,46.29,3676.65
2578,4481.023001,207,1635124,46.33,3689.36
2579,4469.308979,208,1635332,46.33,3693.64
2580,4492.254138,173,1635505,46.35,3706.37
2581,4493.023396,285,1635790,46.34,3706.37
2582,4686.063284,143,1635933,46.32,3706.37
2583,4763.970955,235,1636168,46.31,3706.37
2584,4854.160163,165,1636333,46.29,3706.37
2585,0.000000,0,1636333,46.28,3706.37
2586,6258.034908,28,1636361,46.26,3706.37
2587,0.000000,0,1636361,46.25,3706.37
2588,0.000000,0,1636361,46.23,3706.37
2589,9205.855551,30,1636391,46.21,3706.37
2590,0.000000,0,1636391,46.20,3706.37
2591,11779.884797,4,1636395,46.18,3706.37
2592,0.000000,0,1636395,46.16,3706.37
2593,0.000000,0,1636395,46.15,3706.37
2594,0.000000,0,1636395,46.13,3706.37
2595,15101.884142,4,1636399,46.11,3706.37
2596,0.000000,0,1636399,46.09,3706.37
2597,0.000000,0,1636399,46.08,3706.37
2598,0.000000,0,1636399,46.06,3706.37
2599,18640.799105,1,1636400,46.04,3706.37
2600,0.000000,0,1636400,46.02,3706.37
2601,0.000000,0,1636400,46.00,3706.37
2602,0.000000,0,1636400,45.99,3706.37
2603,23315.949394,2,1636402,45.97,3706.37
2604,0.000000,0,1636402,45.95,3706.37
2605,0.000000,0,1636402,45.94,3706.37
2606,26377.868934,37,1636439,45.92,3706.37
2607,26557.794104,156,1636595,45.91,3706.37
2608,26550.124693,248,1636843,45.89,3706.63
2609,26574.413099,194,1637037,45.88,3706.63
2610,26404.753364,323,1637360,45.91,3706.63
2611,9140.934098,144,1637504,45.90,3706.63
2612,4729.050637,93,1637597,45.90,3706.63
2613,5075.774815,197,1637794,45.93,3706.63
2614,5563.674122,124,1637918,45.94,3706.63
2615,5901.031428,81,1637999,45.96,3706.63
2616,6097.179522,171,1638170,46.00,3706.63
2617,6466.798466,230,1638400,46.00,3706.63
2618,6909.826623,104,1638504,46.00,3706.63
2619,7176.888389,90,1638594,46.00,3706.63
2620,7407.835276,104,1638698,45.99,3706.63
2621,7978.265168,94,1638792,46.00,3706.63
2622,8361.103690,53,1638845,46.01,3706.63
2623,8693.743271,86,1638931,45.99,3706.63
2624,8907.177538,109,1639040,45.98,3706.63
2625,9088.208699,111,1639151,45.98,3706.63
2626,9263.333041,241,1639392,45.99,3708.83
2627,9392.628865,48,1639440,46.01,3708.83
2628,9508.135187,69,1639509,46.00,3708.83
2629,9629.496150,89,1639598,45.98,3708.83
2630,9792.234674,109,1639707,45.96,3729.44
2631,9856.626412,87,1639794,45.99,3750.27
2632,10032.993975,50,1639844,45.98,3750.27
2633,10190.451979,75,1639919,45.96,3750.27
2634,10295.285217,78,1639997,45.95,3750.27
2635,10296.668775,130,1640127,45.94,3750.27
2636,10373.718248,170,1640297,45.92,3750.27
2637,10401.270997,106,1640403,45.91,3750.27
2638,10484.089961,101,1640504,45.90,3750.27
2639,10566.399321,66,1640570,45.92,3751.48
2640,10717.915902,89,1640659,45.97,3751.48
2641,10842.904918,64,1640723,45.96,3751.48
2642,10923.634617,73,1640796,45.95,3751.48
2643,11000.699601,48,1640844,45.93,3751.48
2644,11100.513694,73,1640917,45.92,3751.48
2645,11177.795720,2,1640919,45.90,3751.48
2646,0.000000,0,1640919,45.89,3751.48
2647,0.000000,0,1640919,45.87,3751.48
2648,0.000000,0,1640919,45.86,3751.48
2649,12892.001374,483,1641402,45.85,3751.48
2650,0.000000,0,1641402,45.83,3751.48
2651,0.000000,0,1641402,45.81,3751.48
2652,0.000000,0,1641402,45.83,3753.61
2653,0.000000,0,1641402,45.85,3757.87
2654,0.000000,0,1641402,45.84,3757.87
2655,0.000000,0,1641402,45.82,3757.87
2656,0.000000,0,1641402,45.80,3757.87
2657,14034.806093,711,1642113,45.79,3757.87
2658,0.000000,0,1642113,45.78,3757.87
2659,0.000000,0,1642113,45.77,3757.87
2660,0.000000,0,1642113,45.75,3757.87
2661,12896.834032,129,1642242,45.74,3757.87
2662,7200.590538,650,1642892,45.72,3757.87
2663,2753.711377,649,1643541,45.71,3757.87
2664,1442.124413,780,1644321,45.70,3757.87
2665,1518.056697,585,1644906,45.69,3757.87
2666,1433.061685,650,1645556,45.75,3757.87
2667,1429.457915,845,1646401,45.78,3757.87
2668,1563.128197,390,1646791,45.77,3757.87
2669,1974.784318,390,1647181,45.76,3757.87
2670,2507.364084,389,1647570,45.74,3757.87
2671,2531.028290,389,1647959,45.73,3757.87
2672,2539.562475,391,1648350,45.72,3757.87
2673,2574.675293,415,1648765,45.71,3757.87
2674,2569.359060,326,1649091,45.70,3757.87
2675,2581.220759,414,1649505,45.68,3757.87
2676,2750.183025,386,1649891,45.67,3757.87
2677,2747.579747,265,1650156,45.70,3757.87
2678,2729.852756,415,1650571,45.72,3757.87
2679,2799.155317,388,1650959,45.74,3757.87
2680,2768.294612,327,1651286,45.72,3757.87
2681,2848.998637,350,1651636,45.71,3757.87
2682,2882.250991,324,1651960,45.70,3757.87
2683,2999.116700,326,1652286,45.69,3757.87
2684,3039.073332,350,1652636,45.68,3757.87
2685,3090.148606,262,1652898,45.67,3757.87
2686,3136.694146,387,1653285,45.65,3757.87
2687,3187.330544,222,1653507,45.64,3757.87
2688,3151.492837,389,1653896,45.63,3757.87
2689,3175.272024,264,1654160,45.65,3757.87
2690,3202.027224,346,1654506,45.68,3757.87
2691,3289.466089,203,1654709,45.66,3757.87
2692,3324.612427,382,1655091,45.69,3757.87
2693,3277.124254,261,1655352,45.69,3757.87
2694,3384.492448,289,1655641,45.69,3757.87
2695,3475.985446,258,1655899,45.69,3757.87
2696,3707.735560,261,1656160,45.69,3758.04
2697,3612.807841,347,1656507,45.72,3758.13
2698,3561.652597,201,1656708,45.73,3758.13
2699,3580.116527,319,1657027,45.72,3758.13
2700,3633.224405,261,1657288,45.72,3758.13
2701,3625.675774,289,1657577,45.73,3758.13
2702,3593.289816,224,1657801,45.73,3758.13
2703,3714.280846,278,1658079,45.74,3758.13
2704,3786.051856,274,1658353,45.76,3758.13
2705,3824.984032,289,1658642,45.78,3758.13
2706,3825.215534,222,1658864,45.77,3758.13
2707,3760.858476,281,1659145,45.76,3758.13
2708,3716.068347,239,1659384,45.75,3758.13
2709,3829.273398,267,1659651,45.74,3758.13
2710,3792.557889,311,1659962,45.72,3758.13
2711,3740.056382,253,1660215,45.71,3758.13
2712,3721.401926,294,1660509,45.70,3758.13
2713,3749.646742,201,1660710,45.69,3758.13
2714,3770.972227,316,1661026,45.67,3758.13
2715,3909.993768,253,1661279,45.69,3758.13
2716,3882.136145,295,1661574,45.68,3758.13
2717,3984.782540,138,1661712,45.71,3758.13
2718,3847.610420,316,1662028,45.73,3768.65
2719,3941.538944,251,1662279,45.71,3768.65
2720,3980.346026,295,1662574,45.70,3768.65
2721,3929.453305,138,1662712,45.69,3768.65
2722,3950.899871,318,1663030,45.68,3768.65
2723,3872.622404,251,1663281,45.66,3768.65
2724,3926.079206,294,1663575,45.65,3768.65
2725,3843.183109,228,1663803,45.63,3768.65
2726,3879.014795,277,1664080,45.62,3768.65
2727,3917.538832,202,1664282,45.63,3768.65
2728,3969.564907,295,1664577,45.63,3768.65
2729,3994.132099,172,1664749,45.63,3768.65
2730,4020.655549,332,1665081,45.64,3768.65
2731,3964.802258,203,1665284,45.63,3768.65
2732,4105.178221,165,1665449,45.61,3768.65
2733,4248.089482,261,1665710,45.60,3768.65
2734,4180.170638,321,1666031,45.59,3768.65
2735,4357.727027,198,1666229,45.57,3768.65
2736,4338.255109,219,1666448,45.56,3768.65
2737,4279.574139,205,1666653,45.55,3768.65
2738,4310.471174,272,1666925,45.54,3768.65
2739,4429.629756,237,1667162,45.52,3768.65
2740,4367.947655,188,1667350,45.55,3768.65
2741,4345.128096,228,1667578,45.53,3768.65
2742,4396.530073,181,1667759,45.53,3768.65
2743,4378.610949,300,1668059,45.53,3768.65
2744,4233.222935,229,1668288,45.53,3768.65
2745,4247.348766,225,1668513,45.52,3768.65
2746,4204.377716,227,1668740,45.51,3768.65
2747,4219.295183,292,1669032,45.50,3768.65
2748,4255.150636,229,1669261,45.48,3768.65
2749,4230.895170,189,1669450,45.47,3768.65
2750,4144.185692,270,1669720,45.46,3768.65
2751,4153.738011,246,1669966,45.45,3768.65
2752,4218.956846,201,1670167,45.44,3768.65
2753,4319.396738,250,1670417,45.49,3768.65
2754,4341.217392,232,1670649,45.48,3768.65
2755,4349.306719,205,1670854,45.47,3768.65
2756,4492.068233,230,1671084,45.49,3768.65
2757,4554.752169,197,1671281,45.48,3768.65
2758,4480.771262,297,1671578,45.47,3768.65
2759,4471.410621,171,1671749,45.46,3768.65
2760,4440.519636,217,1671966,45.45,3768.65
2761,4486.951500,205,1672171,45.43,3768.65
2762,4393.508601,247,1672418,45.42,3768.65
2763,4407.622990,237,1672655,45.40,3768.65
2764,4447.387722,271,1672926,45.39,3768.65
2765,4405.708146,161,1673087,45.42,3768.65
2766,4343.649246,265,1673352,45.42,3768.65
2767,4366.301794,232,1673584,45.43,3768.65
2768,4444.412247,167,1673751,45.41,3768.65
2769,4410.837056,281,1674032,45.44,3768.65
2770,4297.501016,249,1674281,45.43,3768.65
2771,4440.813474,172,1674453,45.43,3768.65
2772,4524.970585,234,1674687,45.43,3768.65
2773,4556.208641,240,1674927,45.43,3768.65
2774,4565.610105,222,1675149,45.43,3768.65
2775,4549.842192,162,1675311,45.43,3768.65
2776,4552.861182,270,1675581,45.45,3768.73
2777,4528.207580,172,1675753,45.46,3768.73
2778,4516.420724,281,1676034,45.50,3768.73
2779,4415.432497,249,1676283,45.52,3768.73
2780,4343.996191,236,1676519,45.52,3768.73
2781,4374.052853,202,1676721,45.51,3768.73
2782,4345.249847,245,1676966,45.50,3768.73
2783,4328.211783,267,1677233,45.49,3768.73
2784,4222.163503,187,1677420,45.47,3768.73
2785,4332.996649,237,1677657,45.46,3768.73
2786,4192.671593,272,1677929,45.48,3768.73
2787,4185.553692,226,1678155,45.47,3768.73
2788,4126.159257,264,1678419,45.46,3768.73
2789,3992.001660,239,1678658,45.45,3768.73
2790,4024.642737,228,1678886,45.46,3768.73
2791,4062.249773,287,1679173,45.46,3768.73
2792,4080.589422,182,1679355,45.48,3768.73
2793,4116.247554,240,1679595,45.46,3768.73
2794,4037.971692,226,1679821,45.46,3768.73
2795,4034.252812,335,1680156,45.45,3768.73
2796,4014.839768,264,1680420,45.46,3768.73
2797,4050.300066,175,1680595,45.46,3768.73
2798,4173.424251,227,1680822,45.46,3769.09
2799,4122.971830,270,1681092,45.49,3769.09
2800,4178.570320,142,1681234,45.52,3769.09
2801,4554.089500,222,1681456,45.53,3769.09
2802,0.000000,0,1681456,45.52,3769.09
2803,4895.584335,475,1681931,45.55,3769.09
2804,0.000000,0,1681931,45.55,3769.09
2805,0.000000,0,1681931,45.53,3769.09
2806,0.000000,0,1681931,45.52,3769.09
2807,0.000000,0,1681931,45.51,3769.09
2808,0.000000,0,1681931,45.49,3769.09
2809,0.000000,0,1681931,45.48,3769.09
2810,10468.743432,486,1682417,45.46,3769.09
2811,0.000000,0,1682417,45.45,3769.09
2812,0.000000,0,1682417,45.43,3769.09
2813,0.000000,0,1682417,45.42,3769.09
2814,0.000000,0,1682417,45.40,3769.09
2815,0.000000,0,1682417,45.39,3769.09
2816,0.000000,0,1682417,45.37,3769.09
2817,0.000000,0,1682417,45.36,3769.09
2818,0.000000,0,1682417,45.34,3769.09
2819,16240.219206,195,1682612,45.33,3769.09
2820,0.000000,0,1682612,45.32,3769.09
2821,0.000000,0,1682612,45.30,3769.09
2822,0.000000,0,1682612,45.28,3769.09
2823,0.000000,0,1682612,45.27,3769.09
2824,18823.242426,454,1683066,45.26,3769.09
2825,6956.642403,973,1684039,45.25,3769.09
2826,1325.668281,715,1684754,45.27,3769.09
2827,1439.398115,583,1685337,45.29,3769.09
2828,1657.509743,651,1685988,45.29,3769.17
2829,1219.731595,845,1686833,45.28,3769.17
2830,1389.779602,455,1687288,45.27,3769.17
2831,1529.418699,908,1688196,45.26,3769.17
2832,1346.198052,586,1688782,45.25,3769.17
2833,1424.965135,780,1689562,45.28,3769.17
2834,1500.221208,715,1690277,45.29,3769.17
2835,1364.516917,650,1690927,45.29,3769.17
2836,1347.958787,648,1691575,45.28,3769.17
2837,1597.120633,845,1692420,45.27,3769.17
2838,1217.149161,717,1693137,45.27,3769.17
2839,1384.407620,715,1693852,45.26,3769.17
2840,1486.469616,585,1694437,45.25,3769.17
2841,1438.613851,779,1695216,45.26,3769.17
2842,1528.023192,456,1695672,45.26,3769.17
2843,1987.929604,389,1696061,45.28,3778.70
2844,2609.983503,241,1696302,45.27,3778.70
2845,2684.983708,475,1696777,45.30,3778.70
2846,2736.434963,350,1697127,45.29,3778.70
2847,2550.758035,390,1697517,45.28,3778.70
2848,2625.305889,391,1697908,45.27,3778.70
2849,2677.061958,348,1698256,45.26,3778.70
2850,2769.564113,390,1698646,45.25,3778.70
2851,2806.398245,327,1698973,45.24,3778.70
2852,2823.602057,352,1699325,45.23,3778.70
2853,2848.757836,385,1699710,45.22,3778.70
2854,3004.651360,264,1699974,45.24,3778.70
2855,3027.504779,348,1700322,45.26,3778.70
2856,3109.630976,388,1700710,45.25,3778.70
2857,3104.933404,201,1700911,45.23,3778.70
2858,3219.764201,345,1701256,45.26,3778.70
2859,3244.653066,326,1701582,45.25,3778.70
2860,3271.888961,261,1701843,45.24,3778.70
2861,3367.312146,263,1702106,45.23,3778.70
2862,3484.485247,221,1702327,45.21,3778.70
2863,3522.847967,383,1702710,45.20,3778.70
2864,3545.077352,202,1702912,45.19,3778.70
2865,3611.067889,345,1703257,45.18,3778.70
2866,3723.856083,197,1703454,45.18,3778.70
2867,3744.896899,325,1703779,45.19,3778.70
2868,3649.924361,262,1704041,45.21,3778.70
2869,3646.153532,220,1704261,45.20,3778.70
2870,3671.498065,249,1704510,45.19,3778.70
2871,3606.776239,337,1704847,45.22,3778.70
2872,3621.893900,284,1705131,45.22,3778.70
2873,3627.344248,225,1705356,45.22,3778.70
2874,3559.579311,358,1705714,45.22,3778.70
2875,3618.842447,264,1705978,45.25,3778.70
2876,3531.657316,281,1706259,45.25,3778.70
2877,3528.781186,263,1706522,45.25,3778.70
2878,3552.732317,321,1706843,45.25,3778.70
2879,3538.209056,288,1707131,45.26,3778.70
2880,3580.564430,197,1707328,45.26,3778.79
2881,3663.015765,383,1707711,45.28,3778.79
2882,3662.365688,137,1707848,45.27,3778.79
2883,3768.727062,285,1708133,45.28,3778.87
2884,3845.808689,197,1708330,45.31,3778.96
2885,3954.401726,258,1708588,45.30,3778.96
2886,4063.249455,260,1708848,45.29,3778.96
2887,4121.653519,285,1709133,45.27,3778.96
2888,4128.997538,180,1709313,45.26,3778.96
2889,4199.193801,211,1709524,45.25,3778.96
2890,4256.238524,321,1709845,45.24,3778.96
2891,4288.876954,232,1710077,45.23,3778.96
2892,4292.970263,189,1710266,45.22,3778.96
2893,4450.321444,190,1710456,45.22,3778.96
2894,4385.787308,321,1710777,45.22,3778.96
2895,4404.508381,140,1710917,45.21,3783.90
2896,4468.829895,281,1711198,45.23,3802.20
2897,4474.411969,138,1711336,45.26,3802.20
2898,4468.817368,253,1711589,45.25,3802.20
2899,4576.282055,259,1711848,45.23,3802.20
2900,4587.172323,173,1712021,45.22,3802.20
2901,4622.314394,242,1712263,45.21,3802.20
2902,4735.907627,160,1712423,45.20,3802.20
2903,4736.723809,232,1712655,45.18,3802.20
2904,4825.410024,129,1712784,45.17,3802.20
2905,5607.053608,61,1712845,45.16,3802.20
2906,0.000000,0,1712845,45.16,3802.20
2907,7103.544666,3,1712848,45.17,3802.20
2908,8444.145701,69,1712917,45.15,3802.20
2909,8493.776125,217,1713134,45.14,3802.20
2910,8506.322567,138,1713272,45.13,3802.20
2911,8504.143569,214,1713486,45.12,3802.20
2912,8503.319146,295,1713781,45.14,3802.20
2913,6410.452283,134,1713915,45.13,3802.20
2914,5241.913227,132,1714047,45.12,3802.20
2915,5538.136687,154,1714201,45.10,3802.20
2916,5746.974527,71,1714272,45.09,3802.20
2917,6176.592559,184,1714456,45.08,3802.20
2918,6200.497282,202,1714658,45.07,3802.20
2919,6440.024339,189,1714847,45.06,3802.20
2920,6739.057210,72,1714919,45.07,3802.20
2921,6975.548553,128,1715047,45.06,3802.20
2922,7144.207048,89,1715136,45.05,3802.20
2923,7456.943360,129,1715265,45.03,3802.20
2924,7543.337088,74,1715339,45.06,3802.20
2925,7517.284284,251,1715590,45.05,3802.20
2926,7498.039110,194,1715784,45.03,3802.20
2927,7533.390952,130,1715914,45.02,3802.20
2928,7494.526280,72,1715986,45.01,3802.20
2929,7533.800337,126,1716112,45.00,3802.20
2930,7495.543386,93,1716205,44.98,3802.20
2931,7458.550166,67,1716272,44.97,3802.20
2932,7465.882551,186,1716458,44.99,3802.20
2933,7498.168272,201,1716659,44.98,3802.20
2934,7468.236417,189,1716848,45.01,3802.20
2935,7411.033375,73,1716921,45.00,3802.20
2936,7418.142651,126,1717047,44.98,3802.20
2937,7416.466825,152,1717199,45.01,3802.20
2938,7409.961576,67,1717266,44.99,3802.20
2939,7399.185808,138,1717404,44.98,3802.20
2940,7420.760698,187,1717591,44.97,3802.20
2941,7433.145103,197,1717788,44.96,3802.20
2942,7402.556213,129,1717917,44.95,3802.20
2943,7404.569395,105,1718022,44.94,3802.20
2944,7367.396296,112,1718134,44.93,3802.20
2945,7342.709081,128,1718262,44.92,3802.20
2946,7315.746197,17,1718279,44.93,3802.20
2947,7376.515197,246,1718525,44.96,3802.20
2948,7339.932405,201,1718726,44.94,3802.20
2949,7297.259713,128,1718854,44.93,3802.20
2950,7321.879773,130,1718984,44.94,3802.20
2951,7284.869987,129,1719113,44.95,3802.20
2952,7313.970845,94,1719207,44.95,3802.20
2953,7317.373407,70,1719277,44.94,3802.20
2954,7195.640844,182,1719459,44.94,3802.20
2955,7270.892788,200,1719659,44.94,3802.20
2956,7307.663884,190,1719849,44.94,3802.20
2957,7212.173669,135,1719984,44.96,3802.53
2958,7171.696227,67,1720051,44.97,3802.53
2959,7243.638019,149,1720200,45.00,3802.53
2960,7233.740400,72,1720272,45.03,3802.53
2961,7136.381840,186,1720458,45.02,3802.53
2962,7147.876448,201,1720659,45.01,3802.53
2963,7219.173746,135,1720794,45.00,3802.53
2964,7030.585069,130,1720924,44.99,3802.53
2965,7198.033129,126,1721050,44.98,3802.53
2966,7122.596913,88,1721138,44.97,3802.53
2967,7209.406629,134,1721272,44.96,3802.53
2968,7021.540412,186,1721458,44.98,3802.53
2969,6960.742066,203,1721661,44.97,3802.53
2970,6898.888776,191,1721852,44.95,3802.53
2971,6875.461609,74,1721926,44.94,3802.53
2972,6767.261109,187,1722113,44.95,3802.53
2973,6763.918750,88,1722201,44.96,3802.53
2974,6543.408745,79,1722280,44.97,3802.53
2975,6629.571046,248,1722528,44.96,3802.53
2976,6543.937779,200,1722728,44.96,3802.53
2977,6570.206153,193,1722921,44.96,3802.53
2978,6416.184178,69,1722990,44.96,3802.53
2979,6469.625959,150,1723140,44.96,3802.53
2980,6322.211258,131,1723271,44.95,3825.72
2981,6430.423464,135,1723406,45.02,3844.52
2982,6384.859317,257,1723663,45.02,3844.52
2983,0.000000,0,1723663,45.02,3844.52
2984,7363.793277,326,1723989,45.02,3844.52
2985,0.000000,0,1723989,45.02,3844.52
2986,0.000000,0,1723989,45.03,3844.52
2987,0.000000,0,1723989,45.02,3844.52
2988,0.000000,0,1723989,45.01,3844.52
2989,0.000000,0,1723989,44.99,3844.52
2990,0.000000,0,1723989,44.98,3844.52
2991,0.000000,0,1723989,44.97,3844.52
2992,0.000000,0,1723989,44.95,3844.52
2993,11929.967525,802,1724791,44.94,3844.52
2994,0.000000,0,1724791,44.93,3844.52
2995,0.000000,0,1724791,44.92,3844.52
2996,0.000000,0,1724791,44.90,3844.52
2997,0.000000,0,1724791,44.88,3844.52
2998,0.000000,0,1724791,44.87,3844.52
2999,14917.442830,130,1724921,44.86,3844.52
3000,0.000000,0,1724921,44.87,3844.52
3001,17022.562370,65,1724986,44.86,3844.52
3002,0.000000,0,1724986,44.85,3844.52
3003,0.000000,0,1724986,44.84,3844.52
3004,0.000000,0,1724986,44.82,3844.52
3005,12110.761747,65,1725051,44.81,3844.52
3006,0.000000,0,1725051,44.80,3844.52
3007,13709.081787,390,1725441,44.78,3844.52
3008,8415.413767,843,1726284,44.77,3844.52
3009,1386.797881,844,1727128,44.76,3844.52
3010,1380.772219,583,1727711,44.76,3844.52
3011,1432.533694,651,1728362,44.78,3844.52
3012,1432.561009,845,1729207,44.77,3844.52
3013,1433.140459,650,1729857,44.76,3844.52
3014,1392.100431,715,1730572,44.75,3844.52
3015,1461.890350,390,1730962,44.74,3844.52
3016,1544.414057,1040,1732002,44.73,3844.52
3017,1269.876698,650,1732652,44.76,3844.52
3018,1457.005958,714,1733366,44.78,3844.52
3019,1366.305410,714,1734080,44.77,3844.52
3020,1456.057358,586,1734666,44.77,3844.52
3021,1442.854713,844,1735510,44.76,3844.52
3022,1389.535121,455,1735965,44.75,3844.52
3023,1475.185475,910,1736875,44.74,3844.52
3024,1337.558480,651,1737526,44.74,3844.52
3025,1474.893767,779,1738305,44.73,3853.01
3026,1448.306666,585,1738890,44.78,3862.06
3027,1677.914707,519,1739409,44.77,3862.06
3028,2238.410742,182,1739591,44.76,3862.06
3029,2428.744626,599,1740190,44.78,3862.06
3030,2345.509709,445,1740635,44.78,3862.06
3031,2216.478238,380,1741015,44.77,3862.06
3032,2322.852298,371,1741386,44.76,3862.06
3033,2311.855020,391,1741777,44.75,3862.06
3034,2545.888151,347,1742124,44.74,3862.06
3035,2783.889572,390,1742514,44.73,3862.06
3036,2872.169297,350,1742864,44.72,3862.06
3037,2832.053201,389,1743253,44.73,3862.06
3038,2997.372650,261,1743514,44.76,3862.06
3039,3086.154902,264,1743778,44.75,3862.06
3040,3206.096095,346,1744124,44.74,3862.06
3041,3235.432592,264,1744388,44.73,3862.06
3042,3271.661648,387,1744775,44.72,3862.06
3043,3349.977440,222,1744997,44.75,3862.06
3044,3357.630943,322,1745319,44.74,3862.06
3045,3498.433511,243,1745562,44.73,3862.06
3046,3433.753319,366,1745928,44.72,3862.06
3047,3473.805167,201,1746129,44.71,3862.59
3048,3462.895184,260,1746389,44.70,3862.59
3049,3617.035182,322,1746711,44.69,3862.59
3050,3689.573988,220,1746931,44.68,3862.59
3051,3771.731291,324,1747255,44.69,3862.59
3052,3688.244253,230,1747485,44.72,3862.59
3053,3796.645811,291,1747776,44.71,3862.59
3054,3952.802202,159,1747935,44.70,3862.59
3055,4064.026362,263,1748198,44.70,3862.59
3056,4130.168085,257,1748455,44.74,3862.59
3057,4072.670352,256,1748711,44.73,3862.59
3058,4026.257980,223,1748934,44.73,3862.59
3059,4061.916040,263,1749197,44.76,3862.59
3060,4206.584835,193,1749390,44.77,3862.59
3061,4134.410741,321,1749711,44.77,3862.59
3062,4156.555439,220,1749931,44.77,3862.59
3063,4263.856150,196,1750127,44.77,3862.59
3064,4444.889396,196,1750323,44.77,3862.59
3065,4495.054844,241,1750564,44.79,3862.59
3066,4517.966009,221,1750785,44.78,3862.59
3067,4552.880906,152,1750937,44.77,3862.59
3068,4590.666352,258,1751195,44.79,3862.59
3069,4579.743472,196,1751391,44.80,3862.59
3070,4568.321330,303,1751694,44.80,3862.59
3071,4593.479983,216,1751910,44.79,3862.59
3072,4643.821250,152,1752062,44.78,3862.59
3073,4654.690749,196,1752258,44.77,3862.59
3074,4686.899033,198,1752456,44.76,3862.59
3075,4672.937519,321,1752777,44.75,3862.59
3076,4760.532982,155,1752932,44.74,3862.59
3077,4759.210345,196,1753128,44.73,3862.59
3078,4780.503350,196,1753324,44.73,3862.59
3079,4751.130446,197,1753521,44.74,3862.59
3080,4859.697133,259,1753780,44.73,3862.59
3081,4828.112902,157,1753937,44.74,3871.63
3082,4949.622848,193,1754130,44.73,3871.63
3083,4826.749864,257,1754387,44.76,3871.63
3084,4951.430797,135,1754522,44.75,3871.63
3085,4928.745978,259,1754781,44.73,3871.63
3086,5049.187342,153,1754934,44.72,3871.63
3087,5049.264125,6,1754940,44.71,3871.63
3088,5640.290535,7,1754947,44.70,3871.63
3089,0.000000,0,1754947,44.68,3871.63
3090,0.000000,0,1754947,44.67,3871.63
3091,8729.114174,248,1755195,44.66,3871.63
3092,8782.223568,197,1755392,44.68,3871.63
3093,8765.693360,238,1755630,44.67,3871.63
3094,8759.808350,156,1755786,44.66,3871.63
3095,8744.087028,154,1755940,44.64,3871.63
3096,5372.109149,188,1756128,44.63,3871.63
3097,5524.308032,124,1756252,44.65,3871.63
3098,5750.435410,142,1756394,44.64,3871.63
3099,6064.500715,129,1756523,44.63,3871.63
3100,6508.205716,238,1756761,44.62,3871.63
3101,6691.266599,89,1756850,44.61,3871.63
3102,6821.755379,92,1756942,44.59,3871.63
3103,7114.295962,125,1757067,44.59,3871.63
3104,7319.138811,130,1757197,44.57,3871.63
3105,7559.507834,128,1757325,44.57,3871.63
3106,7709.413348,70,1757395,44.58,3871.63
3107,8138.897798,127,1757522,44.57,3871.63
3108,8127.174625,176,1757698,44.56,3871.63
3109,8159.819424,94,1757792,44.54,3871.63
3110,8172.682226,149,1757941,44.57,3871.63
3111,8094.364833,66,1758007,44.56,3871.63
3112,8145.656697,189,1758196,44.54,3871.63
3113,8081.129955,129,1758325,44.53,3871.63
3114,8144.856772,70,1758395,44.52,3871.63
3115,8030.976615,128,1758523,44.51,3871.63
3116,8034.313515,175,1758698,44.50,3871.63
3117,7976.838767,101,1758799,44.51,3871.63
3118,7960.759640,145,1758944,44.51,3871.63
3119,7952.408495,123,1759067,44.53,3871.63
3120,8019.891222,130,1759197,44.52,3871.63
3121,7465.731129,195,1759392,44.51,3871.63
3122,7314.070625,65,1759457,44.50,3871.63
3123,7369.419686,176,1759633,44.48,3871.63
3124,7329.958298,153,1759786,44.51,3871.63
3125,7456.425986,148,1759934,44.50,3871.63
3126,7421.655987,70,1760004,44.49,3871.63
3127,7468.724259,127,1760131,44.49,3871.63
3128,7457.699262,199,1760330,44.49,3871.63
3129,7441.315634,69,1760399,44.49,3871.63
3130,7522.777202,125,1760524,44.49,3871.63
3131,7576.359866,175,1760699,44.52,3871.63
3132,7536.473954,153,1760852,44.55,3871.63
3133,7612.573645,91,1760943,44.58,3871.63
3134,7657.689543,66,1761009,44.58,3871.63
3135,7615.993281,188,1761197,44.58,3871.63
3136,7646.427457,194,1761391,44.58,3871.63
3137,7593.305059,14,1761405,44.56,3871.63
3138,7670.507007,128,1761533,44.55,3871.63
3139,7655.781608,234,1761767,44.54,3871.63
3140,7723.905679,90,1761857,44.53,3871.63
3141,7700.702155,93,1761950,44.53,3871.63
3142,7753.825375,119,1762069,44.54,3871.63
3143,7826.116152,142,1762211,44.53,3871.63
3144,7797.828768,186,1762397,44.53,3872.07
3145,7670.193637,76,1762473,44.54,3875.88
3146,7596.478686,226,1762699,44.56,3875.88
3147,7523.634337,100,1762799,44.55,3875.88
3148,7463.947452,141,1762940,44.54,3875.88
3149,7488.980275,66,1763006,44.53,3875.88
3150,7415.144014,132,1763138,44.52,3875.88
3151,7364.056581,250,1763388,44.51,3875.88
3152,7293.841393,21,1763409,44.50,3875.88
3153,7232.035431,166,1763575,44.48,3875.88
3154,7234.730998,206,1763781,44.47,3875.88
3155,7194.528423,152,1763933,44.50,3891.78
3156,7066.878700,73,1764006,44.49,3891.78
3157,7060.184991,132,1764138,44.48,3891.78
3158,7049.827442,206,1764344,44.49,3891.78
3159,7180.445753,65,1764409,44.48,3891.78
3160,7054.820192,113,1764522,44.50,3891.78
3161,7277.971096,181,1764703,44.49,3891.78
3162,7694.832591,231,1764934,44.48,3891.78
3163,0.000000,0,1764934,44.47,3891.78
3164,7352.676079,200,1765134,44.46,3891.78
3165,0.000000,0,1765134,44.45,3891.78
3166,0.000000,0,1765134,44.43,3891.78
3167,8031.645045,477,1765611,44.42,3891.78
3168,0.000000,0,1765611,44.41,3891.78
3169,0.000000,0,1765611,44.40,3891.78
3170,0.000000,0,1765611,44.38,3891.78
3171,0.000000,0,1765611,44.37,3891.78
3172,0.000000,0,1765611,44.35,3891.78
3173,0.000000,0,1765611,44.34,3891.78
3174,0.000000,0,1765611,44.33,3891.78
3175,0.000000,0,1765611,44.32,3891.78
3176,14059.694139,195,1765806,44.31,3891.78
3177,0.000000,0,1765806,44.29,3891.78
3178,0.000000,0,1765806,44.28,3891.78
3179,16436.902560,65,1765871,44.27,3891.78
3180,0.000000,0,1765871,44.26,3891.78
3181,0.000000,0,1765871,44.24,3891.78
3182,19837.753303,64,1765935,44.23,3891.78
3183,0.000000,0,1765935,44.21,3891.78
3184,20094.373526,65,1766000,44.20,3891.78
3185,19160.318398,390,1766390,44.19,3891.78
3186,11876.890021,584,1766974,44.20,3891.78
3187,1497.576468,797,1767771,44.20,3891.78
3188,1397.229507,632,1768403,44.23,3891.78
3189,1456.604259,713,1769116,44.22,3891.78
3190,1425.129847,650,1769766,44.21,3891.78
3191,1446.789697,844,1770610,44.23,3891.78
3192,1400.615949,686,1771296,44.24,3891.78
3193,1458.016775,680,1771976,44.23,3891.78
3194,1468.464294,650,1772626,44.26,3891.78
3195,1397.779863,714,1773340,44.25,3891.78
3196,1467.330712,650,1773990,44.27,3891.78
3197,1517.783883,714,1774704,44.26,3891.78
3198,1324.433418,781,1775485,44.26,3891.78
3199,1390.973896,650,1776135,44.25,3891.78
3200,1424.810528,635,1776770,44.25,3891.78
3201,1413.936479,778,1777548,44.26,3891.78
3202,1498.788102,406,1777954,44.32,3891.78
3203,1506.743868,910,1778864,44.32,3891.78
3204,1437.762171,845,1779709,44.36,3891.78
3205,1295.244374,715,1780424,44.36,3891.78
3206,1324.659178,455,1780879,44.36,3891.78
3207,1535.806720,845,1781724,44.39,3891.78
3208,1321.496166,714,1782438,44.41,3891.78
3209,1667.542640,195,1782633,44.41,3891.78
3210,2182.033672,521,1783154,44.40,3891.78
3211,2565.627918,389,1783543,44.42,3891.78
3212,2473.555668,455,1783998,44.41,3891.78
3213,2575.667553,286,1784284,44.40,3891.78
3214,2687.228689,325,1784609,44.39,3891.78
3215,2840.127343,390,1784999,44.39,3891.78
3216,2847.504685,350,1785349,44.38,3891.78
3217,2970.894440,325,1785674,44.43,3891.78
3218,2944.875257,362,1786036,44.42,3891.78
3219,3112.810871,313,1786349,44.41,3891.78
3220,3121.162200,260,1786609,44.40,3891.78
3221,3185.356472,390,1786999,44.39,3891.78
3222,3192.489365,223,1787222,44.38,3891.78
3223,3268.421168,258,1787480,44.37,3891.78
3224,3405.792061,327,1787807,44.36,3891.78
3225,3369.239636,325,1788132,44.36,3891.78
3226,3392.584754,283,1788415,44.38,3891.78
3227,3450.199044,197,1788612,44.37,3891.78
3228,3585.627362,387,1788999,44.36,3891.78
3229,3604.248927,223,1789222,44.35,3914.71
3230,3620.860110,259,1789481,44.38,3939.17
3231,3609.941147,260,1789741,44.39,3939.17
3232,3689.363219,324,1790065,44.38,3939.17
3233,3779.745524,225,1790290,44.37,3939.17
3234,3782.647800,126,1790416,44.36,3939.17
3235,4298.884610,197,1790613,44.35,3939.17
3236,4421.367484,263,1790876,44.35,3939.17
3237,4419.188710,345,1791221,44.35,3939.17
3238,4235.002859,256,1791477,44.38,3939.17
3239,4079.560331,134,1791611,44.38,3939.17
3240,4295.928813,262,1791873,44.37,3939.17
3241,4331.008964,258,1792131,44.37,3939.17
3242,4380.207496,221,1792352,44.37,3939.17
3243,4367.185072,197,1792549,44.38,3939.43
3244,4414.247850,193,1792742,44.41,3939.69
3245,4412.170349,259,1793001,44.44,3939.88
3246,4476.912309,222,1793223,44.44,3939.88
3247,4577.872929,255,1793478,44.43,3939.88
3248,4559.441126,76,1793554,44.41,3939.88
3249,4639.473402,318,1793872,44.41,3939.88
3250,4714.378897,198,1794070,44.40,3939.88
3251,4667.794905,221,1794291,44.39,3939.88
3252,4663.568536,192,1794483,44.37,3939.88
3253,4747.407574,112,1794595,44.36,3939.88
3254,4755.548279,284,1794879,44.35,3939.88
3255,4831.940753,254,1795133,44.34,3939.88
3256,4960.646001,160,1795293,44.34,3942.78
3257,4957.845082,253,1795546,44.35,3950.56
3258,4911.704347,50,1795596,44.37,3950.56
3259,4907.112594,284,1795880,44.36,3950.56
3260,5114.162461,190,1796070,44.35,3950.56
3261,5190.534305,156,1796226,44.34,3950.56
3262,5240.368462,254,1796480,44.33,3950.56
3263,5335.631768,75,1796555,44.32,3950.56
3264,5291.549990,317,1796872,44.31,3950.56
3265,5370.701947,81,1796953,44.30,3950.56
3266,5482.612103,246,1797199,44.29,3950.56
3267,5587.014849,154,1797353,44.28,3950.56
3268,5712.416225,131,1797484,44.30,3950.56
3269,5673.751728,131,1797615,44.29,3951.06
3270,5682.945711,192,1797807,44.30,3972.24
3271,0.000000,0,1797807,44.30,3972.24
3272,7806.600584,64,1797871,44.28,3972.24
3273,0.000000,0,1797871,44.27,3972.24
3274,0.000000,0,1797871,44.26,3972.24
3275,10247.529971,16,1797887,44.25,3972.24
3276,10307.754076,187,1798074,44.27,3972.68
3277,10279.451007,159,1798233,44.26,3972.68
3278,10280.989763,249,1798482,44.25,3972.68
3279,10277.434808,112,1798594,44.24,3972.68
3280,9988.792753,247,1798841,44.23,3972.68
3281,7614.854576,43,1798884,44.24,3972.68
3282,6321.006379,135,1799019,44.24,3972.68
3283,6603.641127,181,1799200,44.22,3972.68
3284,6658.960800,155,1799355,44.21,3972.68
3285,6708.077190,193,1799548,44.20,3972.68
3286,6720.637613,68,1799616,44.22,3972.68
3287,6717.222144,219,1799835,44.21,3972.68
3288,7473.636843,37,1799872,44.20,3972.68
3289,7996.413922,12,1799884,44.19,3972.68
3290,8258.818901,72,1799956,44.18,3972.68
3291,8438.863319,115,1800071,44.16,3972.68
3292,8664.199547,158,1800229,44.15,3972.68
3293,8631.673646,129,1800358,44.14,3972.68
3294,8684.673170,195,1800553,44.13,3972.68
3295,8649.975140,193,1800746,44.15,3972.68
3296,8696.041113,95,1800841,44.15,3972.68
3297,8666.862003,36,1800877,44.13,3972.68
3298,8491.084535,13,1800890,44.12,3972.68
3299,8569.083085,133,1801023,44.11,3972.68
3300,8585.047954,114,1801137,44.14,3972.68
3301,8580.242852,97,1801234,44.12,3972.68
3302,8642.030716,249,1801483,44.12,3972.68
3303,8620.919440,114,1801597,44.11,3972.68
3304,8634.033426,212,1801809,44.10,3972.68
3305,8127.003169,71,1801880,44.09,3972.68
3306,7717.422013,12,1801892,44.07,3972.68
3307,7896.152770,133,1802025,44.06,3972.68
3308,7873.214931,174,1802199,44.08,3972.68
3309,7875.517444,99,1802298,44.11,3972.68
3310,7888.463137,187,1802485,44.10,3972.68
3311,7898.070522,113,1802598,44.09,3972.68
3312,7974.298914,260,1802858,44.08,3972.68
3313,7930.502762,24,1802882,44.07,3972.68
3314,7901.533173,12,1802894,44.06,3972.68
3315,7994.010732,129,1803023,44.08,3972.68
3316,8055.959192,114,1803137,44.08,3972.68
3317,8027.326597,162,1803299,44.08,3972.68
3318,8050.546752,185,1803484,44.08,3972.68
3319,8180.738399,110,1803594,44.08,3972.68
3320,8138.432630,215,1803809,44.08,3972.68
3321,8121.064838,70,1803879,44.08,3972.68
3322,8063.307663,14,1803893,44.12,3972.94
3323,8165.885983,125,1804018,44.16,3973.11
3324,8213.756945,59,1804077,44.17,3973.11
3325,8251.470601,155,1804232,44.17,3973.11
3326,8321.607765,192,1804424,44.16,3973.11
3327,8298.979895,137,1804561,44.15,3973.11
3328,8285.696654,123,1804684,44.14,3973.11
3329,8371.361416,191,1804875,44.13,3973.11
3330,8227.992593,16,1804891,44.12,3973.11
3331,8370.196285,65,1804956,44.11,3973.11
3332,8423.021389,117,1805073,44.10,3973.11
3333,8357.261225,131,1805204,44.11,3973.11
3334,8309.684452,157,1805361,44.11,3973.11
3335,8322.208807,194,1805555,44.10,3973.11
3336,8322.434863,63,1805618,44.12,3973.11
3337,8239.395647,255,1805873,44.14,3973.11
3338,8185.459832,16,1805889,44.13,3973.11
3339,8191.845164,65,1805954,44.11,3973.11
3340,8203.930558,72,1806026,44.10,3973.11
3341,8202.590170,174,1806200,44.09,3973.11
3342,8197.130898,156,1806356,44.08,3973.11
3343,8105.178279,131,1806487,44.07,3973.11
3344,8159.163852,112,1806599,44.06,3973.11
3345,8501.050962,273,1806872,44.05,3973.55
3346,0.000000,0,1806872,44.04,3973.64
3347,0.000000,0,1806872,44.03,3973.64
3348,8924.569315,154,1807026,44.02,3973.64
3349,0.000000,0,1807026,44.02,3973.64
3350,0.000000,0,1807026,44.02,3973.64
3351,8945.603735,397,1807423,44.05,3973.64
3352,0.000000,0,1807423,44.03,3973.64
3353,0.000000,0,1807423,44.02,3973.64
3354,0.000000,0,1807423,44.01,3973.64
3355,0.000000,0,1807423,44.00,3973.64
3356,0.000000,0,1807423,43.98,3973.64
3357,0.000000,0,1807423,43.97,3973.64
3358,0.000000,0,1807423,43.96,3973.64
3359,13303.107329,565,1807988,43.95,3973.64
3360,0.000000,0,1807988,43.94,3973.64
3361,0.000000,0,1807988,43.93,3973.64
3362,0.000000,0,1807988,43.92,3973.64
3363,0.000000,0,1807988,43.90,3973.64
3364,0.000000,0,1807988,43.89,3973.64
3365,15825.172196,65,1808053,43.88,3973.64
3366,0.000000,0,1808053,43.86,3973.64
3367,0.000000,0,1808053,43.85,3973.73
3368,0.000000,0,1808053,43.84,3973.82
3369,0.000000,0,1808053,43.83,3973.82
3370,19261.204955,329,1808382,43.82,3976.22
3371,10247.018338,819,1809201,43.84,3991.81
3372,1303.388065,474,1809675,43.83,3991.81
3373,1530.726343,974,1810649,43.83,3991.81
3374,1138.561712,649,1811298,43.82,3991.81
3375,1424.849189,673,1811971,43.84,3991.81
3376,1530.609942,693,1812664,43.86,3991.81
3377,1343.046020,650,1813314,43.86,3991.81
3378,1483.360702,780,1814094,43.85,3991.81
3379,1379.181141,780,1814874,43.85,3991.81
3380,1367.936429,519,1815393,43.84,3991.81
3381,1536.031098,846,1816239,43.83,3991.81
3382,1472.647845,714,1816953,43.83,3991.81
3383,1464.008866,679,1817632,43.85,3991.81
3384,1376.085549,491,1818123,43.90,3991.81
3385,1476.904268,910,1819033,43.90,3991.81
3386,1258.776012,715,1819748,43.89,3991.81
3387,1423.208901,649,1820397,43.88,3991.81
3388,1418.344679,521,1820918,43.88,3991.81
3389,1426.421020,844,1821762,43.87,3991.81
3390,1380.966743,390,1822152,43.87,3991.81
3391,1618.879537,1040,1823192,43.92,3991.81
3392,1223.372383,390,1823582,43.94,3991.81
3393,1708.139059,389,1823971,43.94,3991.81
3394,2461.503599,456,1824427,43.94,3991.81
3395,2454.941149,454,1824881,43.94,3991.81
3396,2467.414027,349,1825230,43.94,3991.81
3397,2684.123743,328,1825558,44.00,3991.81
3398,2831.714046,388,1825946,44.00,3991.81
3399,2885.454985,285,1826231,44.00,3991.81
3400,3086.307872,261,1826492,44.01,3991.81
3401,3383.007737,261,1826753,44.00,3991.81
3402,3442.923255,283,1827036,43.99,3991.81
3403,3479.383554,327,1827363,43.98,3991.81
3404,3428.667373,261,1827624,43.97,3991.81
3405,3369.858834,324,1827948,44.00,3991.81
3406,3520.026393,283,1828231,44.00,3991.81
3407,3483.035702,326,1828557,44.00,3991.81
3408,3444.703712,261,1828818,44.03,3991.81
3409,3449.277432,285,1829103,44.03,3991.81
3410,3479.703004,299,1829402,44.05,3991.90
3411,3435.957469,287,1829689,44.07,3992.34
3412,3529.007291,260,1829949,44.10,3992.53
3413,3493.975830,292,1830241,44.10,3992.53
3414,3481.026953,255,1830496,44.10,3992.53
3415,3528.674441,261,1830757,44.10,3992.53
3416,3554.444716,291,1831048,44.10,3992.53
3417,3546.972060,354,1831402,44.09,3992.53
3418,3578.940084,225,1831627,44.08,3992.53
3419,3738.045308,257,1831884,44.07,3992.53
3420,3689.778602,222,1832106,44.06,3992.53
3421,3713.904417,362,1832468,44.05,4005.94
3422,3813.217535,221,1832689,44.07,4014.86
3423,3816.841930,262,1832951,44.09,4014.86
3424,3809.714291,283,1833234,44.11,4014.86
3425,3808.972546,235,1833469,44.11,4014.86
3426,3891.591389,223,1833692,44.10,4014.86
3427,3960.069725,258,1833950,44.09,4014.86
3428,4074.711014,220,1834170,44.08,4014.86
3429,4165.045291,298,1834468,44.07,4014.86
3430,4259.755528,160,1834628,44.06,4014.86
3431,4217.598256,257,1834885,44.05,4014.86
3432,4214.580090,220,1835105,44.04,4014.86
3433,4267.656717,274,1835379,44.03,4014.86
3434,4299.387087,121,1835500,44.02,4014.86
3435,4365.101526,265,1835765,44.01,4024.89
3436,4361.438775,252,1836017,44.00,4048.96
3437,4358.321786,283,1836300,44.02,4058.02
3438,5169.056207,2,1836302,44.01,4058.02
3439,0.000000,0,1836302,44.03,4058.02
3440,7059.811350,1,1836303,44.01,4058.02
3441,0.000000,0,1836303,44.00,4058.02
3442,8373.584973,62,1836365,43.99,4058.02
3443,0.000000,0,1836365,43.98,4058.02
3444,10751.935979,1,1836366,43.97,4058.02
3445,0.000000,0,1836366,43.95,4058.02
3446,0.000000,0,1836366,43.94,4058.02
3447,0.000000,0,1836366,43.93,4058.02
3448,14028.327740,37,1836403,43.92,4058.02
3449,0.000000,0,1836403,43.91,4058.02
3450,0.000000,0,1836403,43.89,4058.02
3451,17270.419621,2,1836405,43.88,4058.02
3452,0.000000,0,1836405,43.87,4058.02
3453,0.000000,0,1836405,43.86,4058.02
3454,19906.812881,1,1836406,43.84,4058.02
3455,0.000000,0,1836406,43.83,4058.02
3456,0.000000,0,1836406,43.82,4058.02
3457,23015.512911,62,1836468,43.81,4058.02
3458,23879.926197,147,1836615,43.80,4058.02
3459,22687.840404,704,1837319,43.79,4058.02
3460,6087.224709,296,1837615,43.81,4058.02
3461,2282.529912,321,1837936,43.80,4058.02
3462,2787.394838,383,1838319,43.79,4058.02
3463,3150.133830,131,1838450,43.78,4058.02
3464,3905.948613,104,1838554,43.77,4058.02
3465,4309.915957,193,1838747,43.76,4058.02
3466,4754.741154,190,1838937,43.78,4058.02
3467,5122.860371,256,1839193,43.78,4058.02
3468,5447.936556,213,1839406,43.77,4058.02
3469,5764.684225,46,1839452,43.75,4058.02
3470,6138.890300,37,1839489,43.74,4058.02
3471,6360.370591,191,1839680,43.73,4058.02
3472,6725.617583,127,1839807,43.72,4058.02
3473,6997.612028,128,1839935,43.72,4058.02
3474,7298.912278,131,1840066,43.73,4058.02
3475,7589.484906,191,1840257,43.76,4058.02
3476,7853.439780,150,1840407,43.78,4058.02
3477,8062.203945,44,1840451,43.77,4058.02
3478,8226.009561,19,1840470,43.76,4058.02
3479,8425.921655,147,1840617,43.75,4058.02
3480,8506.143388,69,1840686,43.74,4058.02
3481,8688.375309,125,1840811,43.72,4058.02
3482,8821.749842,126,1840937,43.72,4058.02
3483,8997.561873,128,1841065,43.71,4058.02
3484,9199.448582,129,1841194,43.70,4058.02
3485,9446.440026,128,1841322,43.69,4058.02
3486,9535.046243,89,1841411,43.68,4058.02
3487,9743.108528,43,1841454,43.67,4058.02
3488,9914.053867,16,1841470,43.70,4058.73
3489,10114.683002,145,1841615,43.73,4063.23
3490,10116.248837,69,1841684,43.72,4063.91
3491,10117.326791,125,1841809,43.71,4063.91
3492,10200.469778,95,1841904,43.70,4063.91
3493,10256.915816,101,1842005,43.69,4063.91
3494,10419.854839,123,1842128,43.68,4063.91
3495,10510.940420,129,1842257,43.67,4063.91
3496,10561.887337,128,1842385,43.66,4063.91
3497,10562.991286,30,1842415,43.65,4063.91
3498,10649.328710,44,1842459,43.64,4063.91
3499,10755.475027,13,1842472,43.66,4063.91
3500,10816.660609,146,1842618,43.65,4064.00
3501,10816.523514,68,1842686,43.64,4064.00
3502,10809.344655,126,1842812,43.64,4064.00
3503,10919.428377,117,1842929,43.66,4065.45
3504,10904.355372,78,1843007,43.68,4065.45
3505,10932.805729,121,1843128,43.66,4065.45
3506,10966.992546,129,1843257,43.65,4065.45
3507,10958.363635,148,1843405,43.64,4065.45
3508,10950.782305,11,1843416,43.63,4065.45
3509,11026.288462,42,1843458,43.62,4065.45
3510,11088.996020,13,1843471,43.61,4065.45
3511,11133.955997,146,1843617,43.63,4065.45
3512,11116.921177,68,1843685,43.62,4065.45
3513,11116.945189,125,1843810,43.61,4065.45
3514,11118.587132,66,1843876,43.61,4065.45
3515,11122.179053,127,1844003,43.60,4065.45
3516,11212.256137,119,1844122,43.59,4065.45
3517,11129.700677,133,1844255,43.60,4065.45
3518,11191.643116,129,1844384,43.62,4068.97
3519,11187.727416,30,1844414,43.61,4068.97
3520,11261.321530,39,1844453,43.60,4068.97
3521,11354.788633,14,1844467,43.59,4068.97
3522,11357.664725,26,1844493,43.58,4068.97
3523,11361.438342,188,1844681,43.57,4068.97
3524,11334.655229,126,1844807,43.59,4068.97
3525,11467.452918,65,1844872,43.58,4068.97
3526,11485.696254,69,1844941,43.57,4068.97
3527,11530.544384,126,1845067,43.56,4068.97
3528,11521.820824,125,1845192,43.55,4068.97
3529,11447.938422,128,1845320,43.54,4068.97
3530,11505.903189,90,1845410,43.54,4069.06
3531,11390.099424,11,1845421,43.54,4069.06
3532,11491.136474,40,1845461,43.58,4069.06
3533,11395.043221,13,1845474,43.58,4069.06
3534,11456.475203,145,1845619,43.58,4069.06
3535,11511.667982,70,1845689,43.58,4069.06
3536,11578.059979,124,1845813,43.61,4069.06
3537,11449.189714,98,1845911,43.61,4069.06
3538,11453.948849,94,1846005,43.61,4069.06
3539,11490.927679,125,1846130,43.61,4069.06
3540,11455.653110,128,1846258,43.60,4069.06
3541,11495.968475,128,1846386,43.61,4069.06
3542,11511.594969,30,1846416,43.61,4069.06
3543,11521.604447,41,1846457,43.63,4069.23
3544,11366.684273,12,1846469,43.62,4069.23
3545,11482.591012,83,1846552,43.61,4069.23
3546,11469.816426,130,1846682,43.63,4069.23
3547,11308.833953,126,1846808,43.66,4069.23
3548,11487.641679,64,1846872,43.66,4069.23
3549,11476.995956,70,1846942,43.66,4069.23
3550,11431.253702,126,1847068,43.66,4069.23
3551,11348.011157,128,1847196,43.66,4069.23
3552,11373.929331,128,1847324,43.66,4069.23
3553,11323.758101,88,1847412,43.66,4069.23
3554,11235.180813,42,1847454,43.68,4069.40
3555,11232.925478,13,1847467,43.69,4070.70
3556,11170.699162,23,1847490,43.69,4095.38
3557,11170.716684,192,1847682,43.71,4120.46
3558,11123.799218,126,1847808,43.71,4120.46
3559,11149.874804,65,1847873,43.70,4120.46
3560,11061.464048,70,1847943,43.69,4120.46
3561,11193.427546,124,1848067,43.71,4120.46
3562,11004.196397,129,1848196,43.70,4120.46
3563,10962.910826,128,1848324,43.69,4120.46
3564,0.000000,0,1848324,43.68,4120.46
3565,11895.753209,91,1848415,43.69,4120.46
3566,0.000000,0,1848415,43.69,4120.46
3567,0.000000,0,1848415,43.68,4120.46
3568,0.000000,0,1848415,43.67,4120.46
3569,0.000000,0,1848415,43.66,4120.46
3570,0.000000,0,1848415,43.65,4120.46
3571,0.000000,0,1848415,43.64,4120.46
3572,13880.776958,659,1849074,43.63,4120.46
3573,0.000000,0,1849074,43.62,4120.46
3574,0.000000,0,1849074,43.61,4120.46
3575,0.000000,0,1849074,43.59,4120.46
3576,12612.728698,341,1849415,43.58,4120.46
3577,0.000000,0,1849415,43.57,4120.46
3578,6195.777513,65,1849480,43.56,4120.46
3579,0.000000,0,1849480,43.55,4120.46
3580,0.000000,0,1849480,43.54,4120.46
3581,0.000000,0,1849480,43.52,4120.46
3582,9783.150665,65,1849545,43.53,4120.46
3583,0.000000,0,1849545,43.53,4120.46
3584,0.000000,0,1849545,43.52,4120.46
3585,13210.159276,65,1849610,43.51,4120.46
3586,0.000000,0,1849610,43.50,4120.46
3587,0.000000,0,1849610,43.49,4120.46
3588,0.000000,0,1849610,43.48,4120.46
3589,16959.695192,65,1849675,43.46,4120.46
3590,16903.825910,519,1850194,43.45,4120.46
3591,7585.543101,714,1850908,43.45,4120.46
3592,1461.652461,911,1851819,43.44,4120.46
3593,1148.333118,325,1852144,43.44,4120.46
3594,1558.020662,1040,1853184,43.43,4120.46
3595,1209.102532,585,1853769,43.43,4120.46
3596,1548.756088,844,1854613,43.44,4120.46
3597,1240.763045,519,1855132,43.44,4120.46
3598,1549.017183,778,1855910,43.47,4120.46
3599,1361.786048,650,1856560,43.47,4120.46
3600,1446.322791,780,1857340,43.47,4120.46
3601,1454.695346,780,1858120,43.47,4120.46
3602,1294.689516,649,1858769,43.47,4120.46
3603,1582.363871,530,1859299,43.50,4123.21
3604,1428.891868,834,1860133,43.54,4131.06
3605,1297.010672,716,1860849,43.54,4131.06
3606,1506.895180,715,1861564,43.54,4131.06
3607,1460.080817,648,1862212,43.54,4131.06
3608,1346.847880,587,1862799,43.56,4131.06
3609,1735.230980,777,1863576,43.57,4131.06
3610,1401.280271,521,1864097,43.61,4131.06
3611,1867.715695,327,1864424,43.60,4131.06
3612,2597.692787,325,1864749,43.59,4131.06
3613,2756.103027,390,1865139,43.58,4131.06
3614,2640.227460,287,1865426,43.57,4131.06
3615,2694.776655,388,1865814,43.56,4131.06
3616,2799.726503,390,1866204,43.56,4131.06
3617,2897.918364,287,1866491,43.58,4131.14
3618,2868.657931,389,1866880,43.57,4131.23
3619,2857.408222,326,1867206,43.56,4131.23
3620,2875.512830,284,1867490,43.55,4131.23
3621,3165.315959,324,1867814,43.54,4131.23
3622,3185.776121,328,1868142,43.56,4131.23
3623,3275.704192,268,1868410,43.56,4131.23
3624,3389.465192,273,1868683,43.58,4131.23
3625,3448.332269,327,1869010,43.57,4131.23
3626,3510.247100,314,1869324,43.56,4131.23
3627,3484.197055,232,1869556,43.55,4131.23
3628,3583.862691,260,1869816,43.54,4131.23
3629,3600.159554,323,1870139,43.53,4131.23
3630,3635.231819,263,1870402,43.53,4131.23
3631,3623.490222,220,1870622,43.55,4131.23
3632,3597.501327,195,1870817,43.54,4131.23
3633,4369.987118,63,1870880,43.53,4131.23
3634,0.000000,0,1870880,43.52,4131.23
3635,5856.652282,1,1870881,43.51,4131.23
3636,0.000000,0,1870881,43.50,4131.23
3637,8187.560727,194,1871075,43.49,4131.23
3638,8257.920085,257,1871332,43.48,4131.23
3639,8240.656901,225,1871557,43.47,4131.23
3640,8237.677333,261,1871818,43.46,4131.23
3641,4800.064582,258,1872076,43.48,4131.23
3642,4161.401192,197,1872273,43.47,4131.23
3643,4489.343732,129,1872402,43.46,4131.23
3644,4937.866341,154,1872556,43.45,4131.23
3645,5071.617199,260,1872816,43.47,4131.23
3646,5281.475753,193,1873009,43.46,4131.23
3647,5587.745405,131,1873140,43.45,4131.23
3648,5937.362381,72,1873212,43.44,4131.23
3649,6181.963934,159,1873371,43.43,4131.23
3650,6550.719640,59,1873430,43.42,4131.23
3651,6778.080527,100,1873530,43.41,4131.23
3652,7502.813008,102,1873632,43.40,4131.23
3653,7620.448869,249,1873881,43.42,4131.49
3654,7530.770120,193,1874074,43.41,4131.49
3655,7531.737003,74,1874148,43.40,4131.49
3656,7556.349825,177,1874325,43.39,4131.49
3657,7530.998070,78,1874403,43.38,4131.49
3658,7545.502779,90,1874493,43.37,4131.49
3659,7585.641105,51,1874544,43.39,4131.49
3660,7497.006609,269,1874813,43.41,4131.67
3661,7559.751243,158,1874971,43.41,4131.67
3662,7557.764011,169,1875140,43.40,4131.67
3663,7602.261435,72,1875212,43.39,4131.67
3664,7532.013362,125,1875337,43.38,4131.67
3665,7505.878674,95,1875432,43.37,4131.67
3666,7503.122730,97,1875529,43.36,4131.67
3667,6766.322583,353,1875882,43.35,4131.67
3668,6428.654652,195,1876077,43.37,4131.67
3669,6362.806292,72,1876149,43.36,4131.67
3670,6397.558544,177,1876326,43.35,4131.67
3671,6416.349694,79,1876405,43.34,4131.67
3672,6371.948959,94,1876499,43.33,4131.67
3673,6420.105350,157,1876656,43.34,4131.67
3674,6553.405368,354,1877010,43.37,4131.67
3675,6547.915048,133,1877143,43.36,4131.67
3676,6459.075019,72,1877215,43.35,4131.67
3677,6451.504900,157,1877372,43.34,4131.67
3678,6442.790977,119,1877491,43.33,4131.67
3679,6434.501917,99,1877590,43.33,4131.67
3680,6480.003388,292,1877882,43.32,4131.67
3681,6535.582905,195,1878077,43.31,4131.67
3682,6506.993445,72,1878149,43.33,4131.67
3683,6542.275309,177,1878326,43.32,4131.67
3684,6585.573385,79,1878405,43.31,4131.67
3685,6574.217055,96,1878501,43.30,4131.67
3686,6509.128207,220,1878721,43.29,4131.67
3687,6597.428055,231,1878952,43.28,4131.67
3688,6664.808086,130,1879082,43.33,4136.79
3689,6596.504618,131,1879213,43.32,4136.79
3690,6696.303201,119,1879332,43.31,4136.79
3691,6689.810684,97,1879429,43.31,4136.79
3692,6746.920653,83,1879512,43.30,4136.79
3693,6710.493022,274,1879786,43.29,4136.79
3694,6697.499427,230,1880016,43.28,4136.79
3695,6717.001986,130,1880146,43.29,4136.79
3696,6712.764445,135,1880281,43.31,4136.79
3697,6670.033341,92,1880373,43.31,4136.79
3698,6677.679164,122,1880495,43.31,4136.79
3699,6756.559679,95,1880590,43.31,4136.79
3700,6763.868278,235,1880825,43.31,4136.79
3701,6789.980880,194,1881019,43.31,4136.79
3702,6720.382240,129,1881148,43.33,4136.79
3703,6837.933900,176,1881324,43.39,4137.56
3704,6831.360795,79,1881403,43.39,4137.56
3705,6837.508070,93,1881496,43.39,4137.56
3706,6806.522607,135,1881631,43.39,4137.56
3707,6747.279375,315,1881946,43.38,4137.56
3708,6820.587280,136,1882082,43.37,4137.56
3709,6790.730535,70,1882152,43.36,4137.56
3710,6712.405684,173,1882325,43.35,4137.56
3711,6805.983757,82,1882407,43.34,4137.56
3712,6738.719565,104,1882511,43.34,4137.56
3713,6679.289419,210,1882721,43.33,4137.56
3714,6670.819507,232,1882953,43.32,4137.56
3715,6648.304183,193,1883146,43.33,4137.56
3716,6600.298482,73,1883219,43.33,4137.56
3717,6555.911020,123,1883342,43.32,4137.56
3718,6483.332127,133,1883475,43.37,4137.56
3719,6425.477248,106,1883581,43.37,4137.56
3720,6422.097278,302,1883883,43.36,4137.56
3721,6307.821112,260,1884143,43.35,4137.56
3722,6321.420869,72,1884215,43.34,4137.56
3723,6265.979264,115,1884330,43.33,4137.56
3724,6268.567447,104,1884434,43.32,4137.56
3725,6201.286530,146,1884580,43.31,4137.56
3726,6195.714505,245,1884825,43.30,4137.56
3727,6262.678642,196,1885021,43.30,4137.56
3728,6232.716257,128,1885149,43.29,4137.56
3729,6543.710613,135,1885284,43.28,4137.56
3730,0.000000,0,1885284,43.27,4137.56
3731,0.000000,0,1885284,43.26,4137.56
3732,0.000000,0,1885284,43.27,4137.56
3733,0.000000,0,1885284,43.29,4137.56
3734,0.000000,0,1885284,43.28,4137.56
3735,0.000000,0,1885284,43.27,4137.56
3736,0.000000,0,1885284,43.26,4137.56
3737,0.000000,0,1885284,43.25,4137.56
3738,0.000000,0,1885284,43.24,4137.56
3739,0.000000,0,1885284,43.23,4137.56
3740,0.000000,0,1885284,43.22,4137.56
3741,0.000000,0,1885284,43.20,4137.56
3742,15227.314018,995,1886279,43.20,4137.56
3743,0.000000,0,1886279,43.19,4137.56
3744,0.000000,0,1886279,43.18,4115.47
3745,0.000000,0,1886279,43.17,4115.47
3746,0.000000,0,1886279,43.17,4115.47
3747,0.000000,0,1886279,43.17,4115.47
3748,0.000000,0,1886279,43.16,4115.47
3749,7872.239521,69,1886348,43.16,4115.47
3750,0.000000,0,1886348,43.16,4115.47
3751,0.000000,0,1886348,43.15,4115.87
3752,0.000000,0,1886348,43.15,4115.96
3753,0.000000,0,1886348,43.15,4116.40
3754,12896.332240,100,1886448,43.15,4116.75
3755,13503.892425,745,1887193,43.20,4116.92
3756,7052.007689,260,1887453,43.21,4116.92
3757,1462.262821,1170,1888623,43.21,4116.92
3758,1323.008305,715,1889338,43.20,4116.92
3759,1370.586502,325,1889663,43.19,4116.92
3760,1510.725954,1029,1890692,43.19,4116.92
3761,1327.765313,726,1891418,43.21,4116.92
3762,1467.610938,649,1892067,43.21,4116.92
3763,1376.824319,586,1892653,43.23,4121.12
3764,1416.087614,845,1893498,43.23,4121.12
3765,1406.986978,714,1894212,43.22,4121.12
3766,1472.984034,650,1894862,43.22,4121.12
3767,1510.665111,739,1895601,43.21,4121.12
3768,1453.698425,622,1896223,43.23,4121.12
3769,1348.233421,784,1897007,43.24,4121.12
3770,1482.149755,650,1897657,43.26,4121.12
3771,1349.439502,779,1898436,43.29,4131.59
3772,1447.907190,650,1899086,43.29,4131.59
3773,1436.751793,585,1899671,43.30,4131.59
3774,1433.629450,844,1900515,43.30,4131.59
3775,1395.374982,715,1901230,43.33,4131.59
3776,1368.935042,716,1901946,43.34,4131.59
3777,1381.506473,518,1902464,43.34,4137.13
3778,1495.801965,716,1903180,43.34,4137.13
3779,1428.756114,843,1904023,43.34,4137.13
3780,1519.625726,390,1904413,43.36,4137.84
3781,1749.540724,399,1904812,43.39,4139.15
3782,2284.788873,445,1905257,43.40,4139.15
3783,2431.918018,521,1905778,43.39,4139.15
3784,2243.272464,390,1906168,43.38,4139.15
3785,2458.168607,285,1906453,43.38,4139.15
3786,2815.657864,390,1906843,43.37,4139.15
3787,2872.205547,390,1907233,43.36,4139.15
3788,2932.187491,286,1907519,43.35,4139.15
3789,2940.953136,390,1907909,43.34,4139.15
3790,2922.823324,324,1908233,43.33,4139.15
3791,2966.301705,288,1908521,43.32,4139.15
3792,3010.744003,376,1908897,43.32,4139.15
3793,3019.283024,336,1909233,43.34,4139.15
3794,3019.910757,226,1909459,43.33,4139.15
3795,3004.933521,387,1909846,43.32,4139.15
3796,3115.717897,387,1910233,43.34,4139.33
3797,3106.360937,158,1910391,43.33,4139.33
3798,3268.203543,325,1910716,43.32,4139.33
3799,3304.320790,324,1911040,43.32,4139.33
3800,3428.284539,284,1911324,43.31,4139.33
3801,3512.895872,199,1911523,43.30,4139.33
3802,3575.760698,195,1911718,43.29,4139.33
3803,4322.154092,64,1911782,43.30,4139.33
3804,0.000000,0,1911782,43.30,4139.33
3805,5839.421949,4,1911786,43.29,4139.70
3806,0.000000,0,1911786,43.28,4139.70
3807,8222.433761,64,1911850,43.27,4139.70
3808,0.000000,0,1911850,43.26,4139.70
3809,0.000000,0,1911850,43.25,4139.70
3810,10833.472340,59,1911909,43.24,4139.70
3811,0.000000,0,1911909,43.23,4139.70
3812,0.000000,0,1911909,43.22,4139.70
3813,14326.696610,1,1911910,43.21,4139.70
3814,0.000000,0,1911910,43.20,4139.70
3815,0.000000,0,1911910,43.19,4139.70
3816,0.000000,0,1911910,43.18,4140.05
3817,17412.362059,64,1911974,43.19,4140.05
3818,0.000000,0,1911974,43.19,4140.05
3819,0.000000,0,1911974,43.18,4140.05
3820,19971.291656,518,1912492,43.17,4140.05
3821,15094.163826,488,1912980,43.16,4140.05
3822,1983.642602,321,1913301,43.15,4140.05
3823,2513.764957,383,1913684,43.14,4140.05
3824,2985.101838,290,1913974,43.16,4140.05
3825,3429.555798,198,1914172,43.16,4140.05
3826,3695.852507,194,1914366,43.15,4140.05
3827,4038.770123,239,1914605,43.14,4140.05
3828,4335.025006,208,1914813,43.13,4140.05
3829,4633.044550,165,1914978,43.13,4140.05
3830,5018.807709,132,1915110,43.12,4140.05
3831,5274.876454,188,1915298,43.11,4140.05
3832,5549.700689,133,1915431,43.12,4140.05
3833,5797.095788,177,1915608,43.13,4152.03
3834,6237.508053,141,1915749,43.14,4157.90
3835,6471.338275,162,1915911,43.16,4157.90
3836,6670.651233,71,1915982,43.15,4157.90
3837,6805.959380,129,1916111,43.14,4157.90
3838,6806.045389,188,1916299,43.13,4157.90
3839,7336.428433,68,1916367,43.13,4157.90
3840,7598.780642,120,1916487,43.12,4157.90
3841,8070.080820,75,1916562,43.11,4157.90
3842,8310.576892,126,1916688,43.10,4157.90
3843,8471.498815,126,1916814,43.09,4157.90
3844,8633.146722,100,1916914,43.08,4157.90
3845,8933.504322,75,1916989,43.07,4157.90
3846,8876.803770,183,1917172,43.10,4157.90
3847,9038.443024,126,1917298,43.11,4157.90
3848,9227.777062,66,1917364,43.13,4157.90
3849,9332.111523,69,1917433,43.13,4157.90
3850,9423.083569,64,1917497,43.12,4157.90
3851,9636.262840,110,1917607,43.11,4157.90
3852,10013.061876,80,1917687,43.10,4157.90
3853,10065.865977,126,1917813,43.09,4157.90
3854,10178.059424,99,1917912,43.08,4157.90
3855,10231.683603,67,1917979,43.07,4157.90
3856,10406.503224,129,1918108,43.06,4157.90
3857,10403.766468,131,1918239,43.08,4157.90
3858,10493.396104,65,1918304,43.07,4157.90
3859,10566.925380,64,1918368,43.06,4157.90
3860,10652.196371,108,1918476,43.06,4157.90
3861,10733.192776,81,1918557,43.05,4157.90
3862,10893.250649,50,1918607,43.07,4157.90
3863,11074.230763,78,1918685,43.08,4161.84
3864,11138.850731,126,1918811,43.07,4161.84
3865,11131.340741,100,1918911,43.07,4161.84
3866,11260.024529,64,1918975,43.06,4161.84
3867,11415.874721,69,1919044,43.05,4161.84
3868,11324.627296,184,1919228,43.04,4161.84
3869,11291.429952,72,1919300,43.03,4161.84
3870,11454.523132,64,1919364,43.02,4161.84
3871,11450.635210,68,1919432,43.04,4161.84
3872,11448.951801,65,1919497,43.03,4161.84
3873,11518.410321,67,1919564,43.02,4161.84
3874,11447.755426,58,1919622,43.02,4161.84
3875,11460.498189,127,1919749,43.01,4161.84
3876,11491.348016,128,1919877,43.02,4161.84
3877,11405.982294,41,1919918,43.03,4161.84
3878,11413.554394,65,1919983,43.04,4161.84
3879,11407.374411,131,1920114,43.03,4161.84
3880,11403.823093,179,1920293,43.02,4161.84
3881,11369.968257,15,1920308,43.01,4161.84
3882,11449.799481,64,1920372,43.01,4161.84
3883,11518.231068,109,1920481,43.01,4161.84
3884,11398.884054,76,1920557,43.03,4161.84
3885,11387.884364,54,1920611,43.04,4161.84
3886,11399.075287,77,1920688,43.03,4161.84
3887,11435.943953,126,1920814,43.03,4161.84
3888,11396.030676,99,1920913,43.03,4161.84
3889,11462.174047,65,1920978,43.03,4161.84
3890,11401.082002,70,1921048,43.03,4161.84
3891,11492.846899,191,1921239,43.06,4161.84
3892,11457.172699,64,1921303,43.11,4162.01
3893,11415.497699,62,1921365,43.12,4162.69
3894,11511.285000,70,1921435,43.11,4162.69
3895,11239.036979,63,1921498,43.10,4162.69
3896,11376.328428,107,1921605,43.09,4162.69
3897,11350.325330,20,1921625,43.08,4162.69
3898,11409.357568,124,1921749,43.07,4162.69
3899,11404.071319,130,1921879,43.06,4162.69
3900,11403.738151,41,1921920,43.06,4162.69
3901,11345.124412,66,1921986,43.05,4162.69
3902,11343.519008,193,1922179,43.04,4162.69
3903,11302.829131,121,1922300,43.03,4162.69
3904,11200.199867,15,1922315,43.02,4162.69
3905,11218.202822,119,1922434,43.03,4162.69
3906,11129.917209,63,1922497,43.05,4162.69
3907,11116.202259,73,1922570,43.07,4162.69
3908,11120.785887,55,1922625,43.07,4162.69
3909,11081.217372,129,1922754,43.06,4162.69
3910,10953.448969,126,1922880,43.05,4162.69
3911,10957.648544,96,1922976,43.04,4162.69
3912,10872.298840,68,1923044,43.03,4162.69
3913,10909.670888,6,1923050,43.02,4162.69
3914,11383.894664,192,1923242,43.01,4162.69
3915,0.000000,0,1923242,43.00,4162.69
3916,0.000000,0,1923242,42.99,4162.69
3917,0.000000,0,1923242,42.98,4162.69
3918,0.000000,0,1923242,42.97,4162.69
3919,0.000000,0,1923242,42.97,4162.69
3920,0.000000,0,1923242,42.96,4162.69
3921,13496.521122,634,1923876,42.97,4162.69
3922,0.000000,0,1923876,42.99,4162.69
3923,0.000000,0,1923876,42.98,4162.69
3924,11154.119416,366,1924242,42.98,4162.69
3925,0.000000,0,1924242,42.96,4162.69
3926,0.000000,0,1924242,42.95,4162.69
3927,0.000000,0,1924242,42.94,4162.69
3928,0.000000,0,1924242,42.93,4162.69
3929,0.000000,0,1924242,42.92,4162.69
3930,0.000000,0,1924242,42.91,4162.69
3931,0.000000,0,1924242,42.90,4162.69
3932,0.000000,0,1924242,42.89,4162.69
3933,12798.491963,195,1924437,42.88,4162.69
3934,0.000000,0,1924437,42.87,4162.69
3935,0.000000,0,1924437,42.86,4162.69
3936,0.000000,0,1924437,42.85,4162.69
3937,16356.131737,65,1924502,42.84,4162.69
3938,0.000000,0,1924502,42.83,4162.69
3939,0.000000,0,1924502,42.82,4162.69
3940,19398.455308,130,1924632,42.81,4162.69
3941,13283.962876,974,1925606,42.81,4162.69
3942,1348.605893,650,1926256,42.80,4162.69
3943,1410.965606,780,1927036,42.80,4162.69
3944,1521.752503,650,1927686,42.79,4162.69
3945,1501.214595,650,1928336,42.80,4162.69
3946,1401.423688,778,1929114,42.84,4162.78
3947,1451.023946,641,1929755,42.87,4162.78
3948,1342.233743,465,1930220,42.87,4162.78
3949,1469.170592,975,1931195,42.87,4162.78
3950,1338.567842,715,1931910,42.88,4162.87
3951,1532.156656,585,1932495,42.89,4162.87
3952,1393.894960,779,1933274,42.91,4162.87
3953,1402.761899,651,1933925,42.91,4162.87
3954,1385.614906,649,1934574,42.92,4162.87
3955,1568.733819,845,1935419,42.95,4162.87
3956,1301.360188,586,1936005,42.95,4162.87
3957,1443.325363,779,1936784,42.95,4162.87
3958,1351.044947,604,1937388,42.98,4162.87
3959,1477.733637,758,1938146,43.01,4162.87
3960,1376.790397,519,1938665,43.01,4162.87
3961,1820.729091,585,1939250,43.00,4162.87
3962,2150.728266,390,1939640,42.99,4162.87
3963,2363.900039,300,1939940,42.98,4162.87
3964,2506.056131,480,1940420,42.98,4162.87
3965,2442.841746,415,1940835,42.99,4162.87
3966,2475.456073,327,1941162,42.99,4162.87
3967,2603.476742,325,1941487,42.98,4162.87
3968,2845.842666,349,1941836,42.98,4162.87
3969,2896.576710,391,1942227,42.98,4185.40
3970,2862.109396,326,1942553,42.99,4191.32
3971,2794.598471,349,1942902,42.98,4191.32
3972,2920.070051,325,1943227,42.97,4191.32
3973,2973.948483,391,1943618,42.99,4191.32
3974,2928.258014,286,1943904,42.99,4191.32
3975,2926.309439,388,1944292,42.98,4191.32
3976,2879.661414,262,1944554,42.97,4191.32
3977,3023.020590,351,1944905,42.97,4191.32
3978,3031.551924,389,1945294,42.96,4191.32
3979,3016.540991,280,1945574,42.95,4191.32
3980,3056.888475,330,1945904,42.97,4191.32
3981,3066.647875,327,1946231,42.96,4191.32
3982,3121.364019,323,1946554,42.96,4191.32
3983,3035.492434,283,1946837,42.95,4196.07
3984,3155.093399,328,1947165,42.95,4196.07
3985,3274.604916,322,1947487,42.96,4196.07
3986,3335.334616,326,1947813,42.96,4196.07
3987,3340.919075,168,1947981,42.95,4196.07
3988,3448.561679,347,1948328,42.98,4197.47
3989,3353.556139,357,1948685,43.01,4197.56
3990,3294.213351,223,1948908,43.01,4197.56
3991,3186.762624,404,1949312,43.01,4197.56
3992,3298.853019,306,1949618,43.01,4197.56
3993,3359.753158,284,1949902,43.01,4197.56
3994,3428.762160,170,1950072,43.01,4197.56
3995,3719.677836,265,1950337,43.00,4197.56
3996,3866.527968,281,1950618,42.99,4197.56
3997,3952.355234,263,1950881,42.98,4197.56
3998,4071.383447,127,1951008,42.98,4197.56
3999,4097.301927,330,1951338,43.00,4197.56
4000,4059.858345,282,1951620,42.99,4197.56
4001,4082.807339,197,1951817,42.98,4197.56
4002,4074.879696,191,1952008,42.97,4197.56
4003,4140.500180,290,1952298,42.99,4197.56
4004,4209.392866,256,1952554,42.98,4197.56
4005,4186.895165,262,1952816,42.98,4197.56
4006,4190.521088,160,1952976,42.97,4197.56
4007,4212.322588,229,1953205,42.96,4197.56
4008,4473.930805,154,1953359,42.95,4197.56
4009,4527.849612,324,1953683,42.97,4197.56
4010,4576.564183,200,1953883,42.96,4197.56
4011,4674.648000,128,1954011,42.96,4197.56
4012,4658.457501,286,1954297,42.95,4215.20
4013,4689.187058,130,1954427,42.96,4239.60
4014,4688.973646,326,1954753,42.96,4241.78
4015,4636.717794,159,1954912,42.96,4241.78
4016,4641.035513,228,1955140,42.95,4241.78
4017,4674.249388,163,1955303,42.94,4241.78
4018,0.000000,0,1955303,42.96,4241.78
4019,5693.322455,36,1955339,42.95,4241.78
4020,0.000000,0,1955339,42.94,4241.78
4021,7628.095617,1,1955340,42.93,4241.78
4022,0.000000,0,1955340,42.92,4241.78
4023,0.000000,0,1955340,42.94,4241.78
4024,10575.496799,337,1955677,42.93,4241.78
4025,9165.374533,629,1956306,42.93,4241.78
4026,3031.107359,180,1956486,42.92,4241.78
4027,2483.776198,383,1956869,42.91,4241.78
4028,2990.432852,341,1957210,42.90,4241.78
4029,3369.323460,140,1957350,42.89,4241.78
4030,3867.784348,137,1957487,42.89,4241.78
4031,4194.857583,255,1957742,42.88,4241.78
4032,4549.588432,254,1957996,42.87,4241.78
4033,5037.371893,191,1958187,42.87,4241.78
4034,5255.857132,122,1958309,42.88,4241.78
4035,5504.023759,48,1958357,42.87,4241.78
4036,5834.444374,130,1958487,42.86,4241.78
4037,6156.060286,191,1958678,42.85,4241.78
4038,6532.963132,128,1958806,42.87,4244.52
4039,6905.865364,190,1958996,42.86,4244.52
4040,7140.327412,121,1959117,42.86,4244.52
4041,7437.511551,136,1959253,42.85,4244.52
4042,7676.346967,87,1959340,42.84,4244.52
4043,7940.561386,19,1959359,42.83,4244.52
4044,7986.969922,130,1959489,42.82,4244.52
4045,7990.461044,188,1959677,42.81,4244.52
4046,7987.207547,129,1959806,42.80,4244.52
4047,8014.276444,190,1959996,42.79,4244.52
4048,8000.183965,121,1960117,42.82,4244.52
4049,8061.680732,136,1960253,42.81,4244.52
4050,8106.363034,87,1960340,42.80,4244.52
4051,8052.213383,19,1960359,42.79,4244.52
4052,8080.766694,127,1960486,42.79,4244.52
4053,8067.985929,191,1960677,42.80,4245.23
4054,8040.838393,130,1960807,42.81,4245.23
4055,8034.183724,189,1960996,42.82,4245.23
4056,7754.849225,130,1961126,42.81,4245.23
4057,7632.099311,179,1961305,42.80,4245.23
4058,7597.279529,40,1961345,42.79,4245.23
4059,7614.445581,77,1961422,42.78,4245.23
4060,7652.795170,128,1961550,42.77,4245.23
4061,7611.019332,191,1961741,42.77,4245.23
4062,7697.247981,129,1961870,42.76,4245.23
4063,7757.426283,129,1961999,42.78,4245.23
4064,7709.629241,190,1962189,42.77,4245.23
4065,7705.079181,121,1962310,42.76,4245.23
4066,7759.245801,41,1962351,42.75,4245.23
4067,7704.079288,75,1962426,42.74,4245.23
4068,7694.835675,187,1962613,42.75,4245.23
4069,7733.156394,131,1962744,42.77,4248.13
4070,7693.092566,131,1962875,42.78,4248.13
4071,7610.574422,243,1963118,42.77,4248.13
4072,7680.591651,134,1963252,42.76,4248.13
4073,7749.815375,61,1963313,42.75,4248.13
4074,7766.064324,41,1963354,42.74,4248.13
4075,7838.416824,75,1963429,42.74,4248.13
4076,7791.659193,248,1963677,42.73,4248.13
4077,7804.064673,128,1963805,42.72,4248.13
4078,7793.958762,151,1963956,42.73,4248.13
4079,7811.796511,165,1964121,42.73,4248.13
4080,7806.817655,135,1964256,42.72,4248.13
4081,7794.866382,86,1964342,42.71,4248.13
4082,7765.364991,19,1964361,42.71,4248.13
4083,7764.786802,129,1964490,42.71,4248.13
4084,7864.742314,187,1964677,42.72,4248.13
4085,7888.308915,129,1964806,42.73,4248.13
4086,7871.396135,150,1964956,42.73,4248.13
4087,7941.209489,165,1965121,42.72,4248.13
4088,7943.586082,140,1965261,42.71,4248.13
4089,7942.984235,81,1965342,42.70,4248.13
4090,7941.209840,21,1965363,42.70,4248.13
4091,7957.659837,126,1965489,42.69,4248.13
4092,7954.306899,189,1965678,42.68,4248.13
4093,7970.870840,85,1965763,42.67,4248.13
4094,8013.453771,193,1965956,42.69,4248.22
4095,8013.033730,171,1966127,42.68,4248.22
4096,7957.786486,178,1966305,42.67,4248.22
4097,8010.051937,38,1966343,42.67,4248.22
4098,7966.498618,21,1966364,42.68,4248.22
4099,8050.779954,125,1966489,42.69,4248.22
4100,8005.398581,191,1966680,42.71,4248.22
4101,7941.443516,130,1966810,42.71,4248.22
4102,8066.115068,146,1966956,42.71,4248.22
4103,8079.323725,164,1967120,42.71,4248.22
4104,8062.238240,136,1967256,42.71,4248.22
4105,8062.205224,87,1967343,42.71,4248.22
4106,8035.647114,19,1967362,42.71,4248.22
4107,8067.443352,127,1967489,42.74,4248.22
4108,8088.897253,109,1967598,42.75,4248.22
4109,8161.247132,212,1967810,42.78,4248.22
4110,8031.131299,73,1967883,42.78,4248.22
4111,8133.692898,237,1968120,42.78,4248.22
4112,8113.118312,135,1968255,42.78,4248.22
4113,8105.227887,62,1968317,42.78,4248.22
4114,8106.482370,41,1968358,42.78,4248.22
4115,8096.608080,86,1968444,42.81,4248.22
4116,8125.106665,154,1968598,42.82,4248.83
4117,8035.989056,154,1968752,42.84,4248.83
4118,8178.413028,129,1968881,42.84,4248.83
4119,8179.801401,188,1969069,42.86,4248.83
4120,8253.206596,186,1969255,42.86,4248.83
4121,8203.833353,60,1969315,42.85,4248.83
4122,8182.380158,38,1969353,42.84,4248.83
4123,8301.869928,75,1969428,42.83,4248.83
4124,8214.799908,170,1969598,42.82,4248.83
4125,8152.031782,148,1969746,42.82,4248.83
4126,8251.692093,133,1969879,42.81,4248.83
4127,8230.447052,127,1970006,42.80,4248.83
4128,8221.642898,186,1970192,42.80,4248.83
4129,8170.550504,119,1970311,42.81,4248.83
4130,8131.701182,43,1970354,42.83,4248.83
4131,8050.536572,74,1970428,42.83,4248.83
4132,8000.118611,171,1970599,42.82,4248.83
4133,8053.264604,148,1970747,42.81,4248.83
4134,8011.264109,133,1970880,42.80,4248.83
4135,7908.147055,185,1971065,42.79,4248.83
4136,7880.096830,129,1971194,42.78,4248.83
4137,7820.815609,123,1971317,42.77,4248.83
4138,7793.596523,39,1971356,42.77,4248.83
4139,7864.134094,6,1971362,42.76,4248.83
4140,0.000000,0,1971362,42.75,4248.83
4141,0.000000,0,1971362,42.74,4248.83
4142,9584.699351,521,1971883,42.73,4248.83
4143,0.000000,0,1971883,42.72,4248.83
4144,0.000000,0,1971883,42.71,4248.83
4145,0.000000,0,1971883,42.71,4248.83
4146,0.000000,0,1971883,42.72,4248.83
4147,0.000000,0,1971883,42.71,4248.83
4148,0.000000,0,1971883,42.70,4248.83
4149,0.000000,0,1971883,42.69,4248.83
4150,0.000000,0,1971883,42.68,4248.83
4151,0.000000,0,1971883,42.67,4248.83
4152,0.000000,0,1971883,42.66,4248.83
4153,0.000000,0,1971883,42.66,4248.83
4154,0.000000,0,1971883,42.65,4248.83
4155,0.000000,0,1971883,42.64,4248.83
4156,0.000000,0,1971883,42.63,4248.83
4157,0.000000,0,1971883,42.62,4248.83
4158,0.000000,0,1971883,42.61,4248.83
4159,0.000000,0,1971883,42.61,4260.04
4160,0.000000,0,1971883,42.62,4279.38
4161,0.000000,0,1971883,42.63,4283.13
4162,0.000000,0,1971883,42.63,4283.13
4163,24052.938181,868,1972751,42.63,4283.13
4164,0.000000,0,1972751,42.63,4283.40
4165,0.000000,0,1972751,42.63,4283.75
4166,23887.888042,65,1972816,42.63,4284.10
4167,5698.915446,813,1973629,42.63,4284.45
4168,2066.230899,681,1974310,42.66,4284.54
4169,1448.840860,649,1974959,42.66,4292.06
4170,1426.801008,780,1975739,42.67,4311.44
4171,1416.539056,649,1976388,42.68,4315.93
4172,1499.174526,716,1977104,42.67,4315.93
4173,1328.884986,715,1977819,42.67,4315.93
4174,1462.132287,649,1978468,42.66,4315.93
4175,1444.559131,715,1979183,42.68,4315.93
4176,1448.467604,727,1979910,42.70,4342.08
4177,1428.037645,248,1980158,42.70,4342.08
4178,1490.675034,1171,1981329,42.69,4342.08
4179,1274.664679,715,1982044,42.69,4342.08
4180,1550.688795,713,1982757,42.68,4342.08
4181,1391.383940,521,1983278,42.68,4342.08
4182,1492.144771,845,1984123,42.67,4342.08
4183,1289.601560,585,1984708,42.66,4342.08
4184,1554.007614,843,1985551,42.71,4342.08
4185,1216.659725,716,1986267,42.71,4342.08
4186,1431.324703,650,1986917,42.71,4342.08
4187,1416.673875,716,1987633,42.70,4342.08
4188,1455.783439,650,1988283,42.70,4342.08
4189,1473.540290,64,1988347,42.69,4342.08
4190,2785.285530,1,1988348,42.71,4342.08
4191,0.000000,0,1988348,42.70,4342.08
4192,4600.711831,64,1988412,42.69,4342.08
4193,0.000000,0,1988412,42.68,4342.08
4194,0.000000,0,1988412,42.67,4342.08
4195,7647.144395,1,1988413,42.66,4342.08
4196,0.000000,0,1988413,42.65,4342.08
4197,0.000000,0,1988413,42.64,4342.08
4198,11080.803857,64,1988477,42.63,4342.08
4199,0.000000,0,1988477,42.63,4342.08
4200,0.000000,0,1988477,42.62,4342.08
4201,13239.255048,652,1989129,42.61,4342.08
4202,10624.053582,360,1989489,42.60,4342.08
4203,2167.403635,321,1989810,42.60,4342.08
4204,2651.875403,354,1990164,42.60,4342.08
4205,3155.911883,251,1990415,42.64,4342.08
4206,3396.164572,204,1990619,42.63,4342.08
4207,3798.727077,254,1990873,42.62,4342.08
4208,4162.432103,111,1990984,42.61,4342.08
4209,5020.498712,67,1991051,42.60,4342.08
4210,5739.613081,144,1991195,42.59,4342.08
4211,5867.627278,220,1991415,42.59,4342.08
4212,6279.522873,138,1991553,42.58,4342.08
4213,6551.575139,131,1991684,42.57,4342.08
4214,6911.835409,133,1991817,42.56,4342.08
4215,7147.957236,164,1991981,42.56,4342.08
4216,7467.240823,21,1992002,42.57,4348.70
4217,7768.364294,54,1992056,42.57,4352.35
4218,8187.511429,76,1992132,42.56,4352.35
4219,8457.014135,191,1992323,42.55,4352.35
4220,8635.460735,154,1992477,42.59,4352.35
4221,8917.184685,77,1992554,42.59,4352.35
4222,7549.551681,505,1993059,42.58,4352.35
4223,4782.155309,77,1993136,42.57,4352.35
4224,5132.315888,153,1993289,42.56,4352.35
4225,5628.737796,110,1993399,42.56,4352.35
4226,5658.876592,83,1993482,42.55,4352.35
4227,5651.058892,76,1993558,42.54,4352.35
4228,5979.211245,443,1994001,42.53,4352.35
4229,6235.558410,131,1994132,42.53,4352.35
4230,6269.831938,128,1994260,42.55,4352.35
4231,6192.999952,125,1994385,42.54,4352.35
4232,6201.419214,95,1994480,42.53,4352.35
4233,6182.308930,76,1994556,42.53,4352.35
4234,6288.451987,304,1994860,42.52,4352.35
4235,6326.533475,269,1995129,42.55,4352.35
4236,6338.115453,67,1995196,42.55,4352.35
4237,6274.112400,126,1995322,42.55,4352.35
4238,6310.197758,155,1995477,42.54,4352.35
4239,6278.379220,19,1995496,42.53,4352.35
4240,6306.847385,258,1995754,42.52,4352.35
4241,6397.631117,306,1996060,42.52,4352.35
4242,6385.370123,78,1996138,42.51,4352.35
4243,6408.048183,156,1996294,42.50,4352.35
4244,6383.597238,102,1996396,42.50,4352.35
4245,6414.276856,95,1996491,42.52,4352.35
4246,6403.246218,133,1996624,42.52,4352.35
4247,6340.573110,314,1996938,42.52,4352.35
4248,6301.848159,197,1997135,42.52,4352.35
4249,6280.451801,126,1997261,42.52,4352.35
4250,6289.547553,126,1997387,42.54,4352.35
4251,6232.842747,96,1997483,42.57,4352.35
4252,6218.973290,78,1997561,42.57,4352.35
4253,6327.275554,249,1997810,42.60,4352.44
4254,6396.683802,258,1998068,42.60,4352.44
4255,6422.114388,128,1998196,42.60,4352.44
4256,6387.458355,101,1998297,42.60,4352.44
4257,6335.985195,181,1998478,42.60,4352.44
4258,6327.094490,21,1998499,42.59,4352.44
4259,6232.930989,256,1998755,42.58,4352.44
4260,6323.307843,263,1999018,42.57,4352.44
4261,6259.480945,124,1999142,42.57,4352.44
4262,6212.567827,155,1999297,42.56,4352.44
4263,6096.937531,122,1999419,42.55,4352.44
4264,6066.059543,80,1999499,42.54,4352.44
4265,6019.199125,257,1999756,42.54,4352.44
4266,5984.606264,244,,,
