second,avg_latency_ms_etcd_v2,throughput_etcd_v2,cumulative_throughput_etcd_v2,avg_cpu_etcd_v2,avg_memory_mb_etcd_v2
0,1.902804,128,128,2.91,22.41
1,1.889799,527,655,9.41,26.51
2,1.797710,553,1208,14.19,30.33
3,1.811436,549,1757,17.81,35.53
4,1.823116,547,2304,20.96,38.00
5,1.807284,550,2854,23.36,38.51
6,1.825472,545,3399,25.47,39.17
7,1.835722,541,3940,27.34,40.88
8,1.826058,546,4486,29.04,42.02
9,1.834052,542,5028,30.39,42.96
10,1.804764,552,5580,31.73,44.17
11,1.786843,556,6136,32.83,44.34
12,1.722225,578,6714,33.88,46.43
13,1.777838,559,7273,34.84,47.87
14,1.820693,546,7819,35.79,48.74
15,1.775464,561,8380,36.59,49.44
16,1.752674,568,8948,37.32,50.35
17,1.787628,556,9504,38.01,51.30
18,1.800872,552,10056,38.78,57.56
19,1.802421,552,10608,39.56,68.26
20,1.782445,557,11165,40.02,68.32
21,1.840067,540,11705,40.54,68.32
22,1.983385,502,12207,41.02,70.33
23,1.946872,512,12719,41.46,70.81
24,2.000494,497,13216,41.89,72.01
25,1.990929,500,13716,42.28,72.26
26,1.950963,510,14226,42.63,72.26
27,1.981328,503,14729,42.94,72.26
28,1.990612,500,15229,43.30,72.26
29,1.968131,506,15735,43.59,72.26
30,1.979966,503,16238,43.88,72.54
31,1.931377,515,16753,44.15,72.54
32,1.740783,571,17324,44.33,72.81
33,1.799062,552,17876,44.57,74.29
34,1.805244,551,18427,44.79,74.29
35,1.822534,546,18973,44.97,74.37
36,1.783393,557,19530,45.17,74.37
37,1.891621,526,20056,45.78,112.31
38,1.742509,571,20627,45.93,112.31
39,1.778897,560,21187,46.08,112.39
40,1.782934,558,21745,46.20,112.65
41,1.791173,555,22300,46.32,112.65
42,1.782402,559,22859,46.46,113.01
43,1.816636,548,23407,46.59,113.01
44,1.772778,561,23968,46.71,113.01
45,1.850280,538,24506,46.91,113.01
46,1.875312,531,25037,47.03,113.01
47,1.859405,534,25571,47.20,113.01
48,1.935258,514,26085,47.36,113.09
49,1.888349,527,26612,47.51,113.09
50,1.944656,512,27124,47.68,113.09
51,1.943064,512,27636,47.80,113.09
52,2.379828,418,28054,47.87,113.11
53,2.334147,427,28481,47.94,113.11
54,2.359161,422,28903,48.05,113.11
55,1.936426,515,29418,48.15,113.11
56,1.921596,518,29936,48.40,113.19
57,1.878439,530,30466,48.90,153.60
58,1.865521,533,30999,49.02,153.60
59,1.858812,535,31534,49.11,153.60
60,1.920156,519,32053,49.17,153.60
61,2.011264,495,32548,49.22,153.60
62,1.851476,538,33086,49.26,153.60
63,1.827702,544,33630,49.26,153.60
64,1.873063,532,34162,49.31,153.60
65,1.858579,535,34697,49.34,153.60
66,1.861585,535,35232,49.36,154.28
67,1.947221,511,35743,49.38,154.99
68,1.880759,528,36271,49.37,155.76
69,1.855673,536,36807,49.38,155.93
70,1.869372,533,37340,49.42,155.93
71,1.830498,544,37884,49.44,156.02
72,1.811249,550,38434,49.49,156.10
73,1.813746,549,38983,49.52,156.10
74,1.808960,550,39533,49.53,156.10
75,1.910649,521,40054,49.56,156.10
76,1.892255,526,40580,50.07,200.63
77,1.838879,541,41121,50.10,200.63
78,1.824659,546,41667,50.13,200.63
79,1.877790,529,42196,50.13,200.63
80,1.867176,533,42729,50.13,200.63
81,1.935704,515,43244,50.16,200.63
82,2.118240,469,43713,50.16,200.63
83,2.159111,462,44175,50.18,200.63
84,2.130926,468,44643,50.21,200.63
85,2.100833,474,45117,50.24,200.66
86,2.080623,479,45596,50.28,200.74
87,2.117807,469,46065,50.30,200.74
88,2.045786,488,46553,50.28,200.74
89,2.046777,486,47039,50.32,200.74
90,2.041120,488,47527,50.35,200.74
91,2.032599,489,48016,50.36,200.74
92,1.819688,547,48563,50.36,200.74
93,1.800136,552,49115,50.37,200.82
94,1.780648,559,49674,50.40,200.90
95,2.073047,479,50153,50.42,200.90
96,1.883988,528,50681,50.93,250.30
97,1.891408,527,51208,50.92,250.30
98,1.858317,535,51743,50.91,250.30
99,1.855557,536,52279,50.92,250.30
100,1.819599,547,52826,50.92,250.30
101,1.842144,540,53366,50.91,250.30
102,1.848915,538,53904,50.91,251.38
103,1.867612,533,54437,50.91,251.88
104,1.863728,534,54971,50.91,252.56
105,1.864198,534,55505,50.91,252.56
106,1.845836,540,56045,50.95,252.56
107,1.903955,523,56568,51.01,252.74
108,1.836642,542,57110,51.06,252.74
109,1.932093,515,57625,51.11,252.91
110,1.922028,517,58142,51.18,253.00
111,1.875166,531,58673,51.20,253.00
112,2.222238,447,59120,51.24,253.00
113,2.213493,449,59569,51.27,253.00
114,2.453847,406,59975,51.29,253.00
115,1.934938,514,60489,51.80,320.47
116,1.849322,539,61028,51.88,320.47
117,1.863846,534,61562,51.92,320.47
118,1.868713,532,62094,51.95,320.47
119,1.894525,526,62620,51.98,320.47
120,1.925420,516,63136,52.04,320.47
121,1.938757,513,63649,52.06,320.47
122,1.848015,538,64187,52.08,320.47
123,1.811242,550,64737,52.07,320.47
124,1.815438,548,65285,52.07,320.47
125,1.821967,547,65832,52.08,320.47
126,1.872560,531,66363,52.08,320.47
127,1.810385,546,66909,52.10,320.47
128,1.874771,534,67443,52.09,320.47
129,1.804030,551,67994,52.09,320.47
130,1.807233,551,68545,52.08,320.47
131,1.803563,551,69096,52.07,320.47
132,1.800325,552,69648,52.07,320.47
133,2.068367,481,70129,52.06,320.47
134,1.807463,552,70681,52.61,336.62
135,1.772023,562,71243,52.61,336.62
136,1.771359,561,71804,52.60,336.62
137,1.772519,561,72365,52.61,336.62
138,1.811466,549,72914,52.61,336.62
139,1.798640,553,73467,52.60,336.62
140,1.822050,547,74014,52.61,336.62
141,1.872362,531,74545,52.60,336.62
142,1.997145,499,75044,52.61,336.62
143,1.980628,503,75547,52.62,336.62
144,1.946762,512,76059,52.64,336.62
145,2.050172,485,76544,52.66,336.62
146,2.035702,489,77033,52.66,336.62
147,2.147705,464,77497,52.66,336.62
148,2.212712,450,77947,52.64,336.70
149,2.051068,486,78433,52.63,337.39
150,2.029562,490,78923,52.65,339.52
151,1.930873,516,79439,52.64,340.44
152,2.125485,469,79908,52.65,340.61
153,1.824958,545,80453,53.16,379.36
154,1.743347,571,81024,53.15,379.36
155,1.766760,563,81587,53.14,379.36
156,1.756346,565,82152,53.14,379.36
157,1.778998,560,82712,53.13,379.36
158,1.844802,539,83251,53.16,379.36
159,1.773347,561,83812,53.15,379.36
160,1.732083,574,84386,53.14,379.36
161,1.746654,570,84956,53.15,379.36
162,1.756321,567,85523,53.15,379.36
163,1.766933,563,86086,53.15,379.36
164,1.770273,561,86647,53.15,379.36
165,1.896872,525,87172,53.16,379.36
166,1.856950,536,87708,53.17,379.36
167,1.856406,535,88243,53.20,379.36
168,2.090159,477,88720,53.22,379.36
169,1.886775,527,89247,53.26,379.36
170,2.086900,477,89724,53.27,379.36
171,1.987783,501,90225,53.52,379.44
172,2.384399,418,90643,53.77,405.25
173,2.329638,428,91071,53.78,405.25
174,2.342295,425,91496,53.78,405.25
175,2.008577,496,91992,53.78,405.25
176,1.934101,514,92506,53.78,405.25
177,1.921073,518,93024,53.81,405.25
178,1.924275,516,93540,53.83,405.25
179,1.930516,516,94056,53.83,405.25
180,1.911280,520,94576,53.84,405.25
181,1.969052,506,95082,53.85,405.25
182,1.817388,547,95629,53.85,405.25
183,1.793683,554,96183,53.84,405.25
184,1.814721,548,96731,53.84,405.25
185,1.824570,545,97276,53.85,405.25
186,1.805714,551,97827,53.84,405.25
187,1.800260,553,98380,53.83,405.25
188,1.984942,501,98881,53.80,405.25
189,1.830243,544,99425,53.79,405.25
190,2.075964,480,99905,53.78,405.25
191,1.932367,515,100420,54.29,435.73
192,1.820312,547,100967,54.28,435.73
193,1.839500,542,101509,54.27,435.80
194,1.849887,538,102047,54.27,435.80
195,1.791126,555,102602,54.26,435.80
196,1.753278,567,103169,54.26,435.80
197,1.805359,551,103720,54.24,435.80
198,1.761248,565,104285,54.24,435.80
199,1.774498,561,104846,54.23,435.80
200,1.756035,567,105413,54.23,435.80
201,1.827294,544,105957,54.21,435.80
202,1.967210,506,106463,54.21,435.80
203,2.185984,455,106918,54.20,437.87
204,2.067295,481,107399,54.22,437.87
205,2.035691,489,107888,54.22,437.87
206,2.082652,477,108365,54.20,437.87
207,2.032209,491,108856,54.19,437.87
208,2.076255,479,109335,54.19,439.92
209,2.395206,415,109750,54.18,442.14
210,2.355350,423,110173,54.64,456.31
211,2.005138,496,110669,54.82,548.87
212,1.848380,538,111207,54.81,548.87
213,1.841687,540,111747,54.79,548.87
214,1.856805,536,112283,54.77,548.87
215,1.850295,538,112821,54.75,548.87
216,1.865779,532,113353,54.73,548.87
217,1.857704,536,113889,54.71,548.87
218,1.828166,544,114433,54.69,548.87
219,1.855734,536,114969,54.66,548.87
220,1.859041,535,115504,54.64,548.87
221,1.854425,537,116041,54.62,548.87
222,1.883481,528,116569,54.60,548.87
223,1.987823,500,117069,54.58,548.87
224,1.759252,566,117635,54.55,548.87
225,1.812186,548,118183,54.55,548.87
226,1.834076,542,118725,54.55,548.87
227,1.863633,533,119258,54.56,548.87
228,2.223513,448,119706,54.57,548.87
229,2.087539,476,120182,54.98,548.87
230,1.927161,516,120698,55.19,610.97
231,1.935541,514,121212,55.19,610.97
232,2.291666,435,121647,55.19,610.97
233,2.275861,437,122084,55.18,610.97
234,2.357774,421,122505,55.17,610.97
235,1.969634,506,123011,55.16,610.97
236,1.856465,535,123546,55.16,610.97
237,1.834186,542,124088,55.16,610.97
238,1.844738,539,124627,55.17,610.97
239,1.873396,532,125159,55.17,610.97
240,1.882188,528,125687,55.17,610.97
241,1.982436,502,126189,55.17,610.97
242,1.828647,544,126733,55.16,610.97
243,1.976173,504,127237,55.12,610.97
244,1.803661,551,127788,55.11,610.97
245,1.816954,547,128335,55.09,610.97
246,1.796336,554,128889,55.10,610.97
247,1.821690,546,129435,55.09,610.97
248,2.360354,422,129857,55.16,611.14
249,1.998353,499,130356,55.65,646.34
250,1.799110,553,130909,55.62,646.34
251,1.758672,565,131474,55.60,646.34
252,1.769127,563,132037,55.59,646.34
253,1.785382,558,132595,55.58,646.34
254,1.835722,542,133137,55.57,646.34
255,1.796637,553,133690,55.56,646.34
256,1.803728,551,134241,55.54,646.34
257,1.772364,561,134802,55.53,646.34
258,1.780437,559,135361,55.52,646.34
259,1.810002,550,135911,55.51,646.34
260,1.801672,553,136464,55.50,646.34
261,1.896741,525,136989,55.48,646.34
262,1.959601,507,137496,55.51,646.34
263,2.237057,446,137942,55.48,646.34
264,2.071108,481,138423,55.47,646.34
265,2.091153,476,138899,55.46,646.34
266,2.048590,486,139385,55.44,646.34
267,2.497971,398,139783,55.51,646.41
268,2.209595,451,140234,55.97,673.98
269,1.993522,499,140733,55.95,673.98
270,1.939565,513,141246,55.95,673.98
271,1.955079,509,141755,55.94,673.98
272,1.776527,560,142315,55.92,673.98
273,1.759300,566,142881,55.91,673.98
274,1.760710,565,143446,55.90,673.98
275,1.774415,561,144007,55.89,673.98
276,1.734419,574,144581,55.88,673.98
277,1.758964,566,145147,55.87,673.98
278,1.741375,572,145719,55.87,673.98
279,1.760263,565,146284,55.85,673.98
280,1.768519,563,146847,55.84,673.98
281,1.733883,575,147422,55.82,673.98
282,1.770659,561,147983,55.81,673.98
283,2.002782,497,148480,55.79,673.98
284,1.774868,560,149040,55.76,673.98
285,2.147659,464,149504,55.76,673.98
286,2.216341,446,149950,56.05,674.15
287,1.868601,536,150486,56.30,695.63
288,1.840740,540,151026,56.30,695.63
289,1.826579,545,151571,56.30,695.63
290,1.902112,523,152094,56.29,695.63
291,1.836732,542,152636,56.30,695.63
292,2.276988,437,153073,56.29,695.63
293,2.312801,431,153504,56.28,695.63
294,2.237964,445,153949,56.28,695.63
295,1.990838,500,154449,56.27,695.63
296,1.852703,536,154985,56.27,695.63
297,1.841739,540,155525,56.27,695.63
298,2.126579,468,155993,56.26,695.63
299,1.961662,507,156500,56.24,695.63
300,1.832496,543,157043,56.24,695.63
301,1.900231,523,157566,56.23,695.63
302,1.819132,548,158114,56.22,695.63
303,1.787240,556,158670,56.21,695.63
304,1.813550,548,159218,56.19,695.63
305,2.234652,446,159664,56.22,695.63
306,2.084668,477,160141,56.62,696.05
307,1.810712,550,160691,56.70,698.78
308,1.776332,560,161251,56.68,698.78
309,1.763808,564,161815,56.67,698.78
310,1.825168,545,162360,56.65,698.78
311,1.780158,558,162918,56.64,698.78
312,1.762941,564,163482,56.63,698.78
313,1.909393,521,164003,56.64,698.78
314,1.812793,548,164551,56.63,698.78
315,1.756135,567,165118,56.62,698.78
316,1.754471,567,165685,56.60,698.78
317,1.745836,570,166255,56.59,698.78
318,2.081235,479,166734,56.57,698.78
319,1.784146,557,167291,56.54,698.78
320,1.819862,548,167839,56.53,698.78
321,1.824953,545,168384,56.52,698.78
322,1.956761,509,168893,56.51,698.78
323,2.037938,457,169350,56.50,698.78
324,2.500302,425,169775,56.68,698.78
325,2.207890,450,170225,57.08,725.64
326,2.006913,496,170721,57.06,725.64
327,2.010343,495,171216,57.05,725.64
328,1.989787,500,171716,57.05,725.64
329,2.003049,497,172213,57.05,725.64
330,1.971379,505,172718,57.03,725.64
331,1.939983,513,173231,57.02,725.64
332,1.790069,555,173786,57.01,725.64
333,1.783166,558,174344,57.00,725.64
334,1.793726,555,174899,56.99,725.64
335,1.785520,556,175455,56.98,725.64
336,1.784246,558,176013,56.97,725.64
337,1.781598,559,176572,56.96,725.64
338,2.136400,466,177038,56.95,725.64
339,1.786824,557,177595,56.90,725.64
340,1.822927,546,178141,56.90,725.64
341,1.788141,557,178698,56.88,725.64
342,1.803556,552,179250,56.86,725.64
343,2.356595,423,179673,56.99,725.64
344,1.974953,504,180177,57.34,800.00
345,1.818067,548,180725,57.34,804.78
346,1.824058,545,181270,57.34,804.78
347,1.839362,542,181812,57.34,804.78
348,1.892289,525,182337,57.35,804.78
349,1.982257,502,182839,57.36,804.78
350,1.906692,521,183360,57.35,804.78
351,1.907321,522,183882,57.35,804.78
352,2.233429,446,184328,57.34,804.78
353,2.266152,439,184767,57.33,804.78
354,2.327974,427,185194,57.32,804.78
355,2.024210,492,185686,57.31,804.78
356,1.946153,512,186198,57.29,804.85
357,1.918947,518,186716,57.29,804.85
358,2.250770,443,187159,57.28,804.85
359,1.927718,516,187675,57.24,804.85
360,1.963498,507,188182,57.24,804.85
361,1.998450,497,188679,57.23,804.85
362,1.858557,535,189214,57.22,804.85
363,2.379233,419,189633,57.36,804.85
364,2.078579,479,190112,57.71,806.90
365,1.818882,547,190659,57.76,832.25
366,1.785914,557,191216,57.75,832.25
367,1.787536,557,191773,57.73,832.25
368,1.806401,551,192324,57.72,832.25
369,1.808730,550,192874,57.70,832.25
370,1.811279,549,193423,57.68,832.25
371,1.775346,559,193982,57.67,832.25
372,1.800381,553,194535,57.65,832.25
373,1.772912,561,195096,57.64,832.25
374,1.770717,562,195658,57.63,832.25
375,1.794657,554,196212,57.62,832.25
376,1.791207,556,196768,57.60,832.25
377,1.764281,564,197332,57.58,832.25
378,2.199566,453,197785,57.57,832.25
379,1.771044,562,198347,57.52,832.25
380,1.768065,563,198910,57.51,832.25
381,2.387093,417,199327,57.54,832.25
382,2.194900,454,199781,57.81,832.33
383,2.073074,480,200261,58.02,840.76
384,1.961347,508,200769,58.01,840.76
385,2.011466,495,201264,58.01,840.76
386,2.026573,491,201755,58.00,840.76
387,1.991014,500,202255,57.99,840.76
388,2.184025,456,202711,57.99,840.76
389,2.060234,483,203194,57.98,840.76
390,2.042991,487,203681,57.97,840.76
391,1.936038,514,204195,57.96,840.76
392,1.847614,539,204734,57.94,840.76
393,1.838902,540,205274,57.92,840.76
394,1.876083,531,205805,57.90,840.76
395,1.857574,535,206340,57.88,840.76
396,1.839635,542,206882,57.86,840.76
397,1.834082,543,207425,57.84,840.76
398,1.890152,479,207904,57.83,840.76
399,2.152178,504,208408,57.78,840.76
400,1.844060,540,208948,57.77,840.76
401,2.168414,459,209407,57.80,840.76
402,1.889170,527,209934,58.12,841.00
403,2.520214,395,210329,58.37,955.44
404,1.759744,566,210895,58.36,955.44
405,1.833131,543,211438,58.35,955.44
406,1.849624,538,211976,58.35,955.44
407,1.804103,551,212527,58.34,955.44
408,1.867626,533,213060,58.34,955.44
409,1.913134,520,213580,58.33,955.44
410,1.945334,511,214091,58.33,955.44
411,1.904289,523,214614,58.32,955.44
412,2.236038,445,215059,58.31,955.44
413,2.256210,429,215488,58.31,955.44
414,2.941308,348,215836,58.26,955.44
415,1.903200,524,216360,58.25,955.44
416,1.865315,533,216893,58.24,955.44
417,1.839306,542,217435,58.23,955.44
418,1.846539,539,217974,58.23,955.44
419,1.839830,540,218514,58.23,955.44
420,1.893243,525,219039,58.22,955.44
421,2.475363,403,219442,58.31,957.59
422,2.022657,492,219934,58.63,967.63
423,2.053038,485,220419,58.80,1140.93
424,1.771229,562,220981,58.78,1140.93
425,1.807218,550,221531,58.77,1140.93
426,1.781120,559,222090,58.75,1140.93
427,1.786033,557,222647,58.74,1140.93
428,1.795499,554,223201,58.72,1140.93
429,1.799476,553,223754,58.70,1140.93
430,1.785906,557,224311,58.69,1140.93
431,1.704215,584,224895,58.68,1140.93
432,1.735238,574,225469,58.66,1140.93
433,1.768786,563,226032,58.65,1140.93
434,2.398506,415,226447,58.60,1140.93
435,1.760891,566,227013,58.59,1140.93
436,1.788642,557,227570,58.57,1140.93
437,1.755265,567,228137,58.55,1140.93
438,1.725139,577,228714,58.54,1140.93
439,2.276552,437,229151,58.54,1140.93
440,1.792750,554,229705,58.73,1141.70
441,2.191950,455,230160,59.03,1228.09
442,1.968906,505,230665,59.03,1228.09
443,1.995903,499,231164,59.02,1228.09
444,1.986962,501,231665,59.02,1228.09
445,2.014217,495,232160,59.01,1228.09
446,1.983771,502,232662,59.00,1228.09
447,2.009330,496,233158,58.99,1228.09
448,2.031018,490,233648,58.98,1228.09
449,1.995982,498,234146,58.97,1228.09
450,2.011653,494,234640,58.96,1228.09
451,1.904606,522,235162,58.95,1228.09
452,1.773234,560,235722,58.94,1228.09
453,1.792886,555,236277,58.93,1228.09
454,2.516953,396,236673,58.89,1228.09
455,1.785152,557,237230,58.86,1228.09
456,1.797084,553,237783,58.84,1228.09
457,1.794352,554,238337,58.83,1228.09
458,1.943714,513,238850,58.84,1228.09
459,2.415865,412,239262,58.87,1228.09
460,2.014109,494,239756,59.10,1228.09
461,2.080191,479,240235,59.31,1255.87
462,1.775334,560,240795,59.37,1255.87
463,1.767302,562,241357,59.35,1255.87
464,1.791087,556,241913,59.34,1255.87
465,1.857747,535,242448,59.33,1255.87
466,1.888417,527,242975,59.33,1255.87
467,1.907314,522,243497,59.31,1255.87
468,1.913240,520,244017,59.30,1255.87
469,1.943844,512,244529,59.30,1255.87
470,1.887060,527,245056,59.30,1255.87
471,1.846765,538,245594,59.29,1255.87
472,2.122899,468,246062,59.28,1255.87
473,2.147457,464,246526,59.27,1255.87
474,3.030621,329,246855,59.24,1255.87
475,1.946696,511,247366,59.21,1255.87
476,1.879063,530,247896,59.21,1255.87
477,1.952220,510,248406,59.19,1255.87
478,1.952395,510,248916,59.18,1255.87
479,2.618188,381,249297,59.23,1255.87
480,2.069554,475,249772,59.42,1255.87
481,2.148067,469,250241,59.57,1257.39
482,1.806167,551,250792,59.63,1260.62
483,1.760573,565,251357,59.61,1260.62
484,1.809392,549,251906,59.60,1260.62
485,1.779699,559,252465,59.58,1260.62
486,1.828753,544,253009,59.58,1260.62
487,1.900269,523,253532,59.56,1260.62
488,1.877443,530,254062,59.54,1260.62
489,1.894922,526,254588,59.52,1260.62
490,1.928418,516,255104,59.50,1260.62
491,1.832266,542,255646,59.48,1260.62
492,1.776188,560,256206,59.46,1260.62
493,1.754758,567,256773,59.45,1260.62
494,2.532991,393,257166,59.41,1260.62
495,1.895569,524,257690,59.38,1260.62
496,1.828611,544,258234,59.36,1260.62
497,1.821719,546,258780,59.34,1260.62
498,2.710751,368,259148,59.39,1260.62
499,1.814537,548,259696,59.53,1260.62
500,2.119082,470,260166,59.76,1263.43
501,1.887557,526,260692,59.91,1265.48
502,2.061892,483,261175,59.89,1265.48
503,2.064174,482,261657,59.88,1265.48
504,2.052196,485,262142,59.87,1265.48
505,2.024523,492,262634,59.86,1265.48
506,2.036307,488,263122,59.84,1265.48
507,2.018844,493,263615,59.83,1265.48
508,2.057744,484,264099,59.82,1265.48
509,2.001812,497,264596,59.80,1265.48
510,2.032853,490,265086,59.78,1265.48
511,1.959341,508,265594,59.77,1265.48
512,1.814943,549,266143,59.75,1265.48
513,1.775381,560,266703,59.73,1265.48
514,2.017205,417,267120,59.72,1265.48
515,2.209464,521,267641,59.67,1265.48
516,1.823911,545,268186,59.65,1265.48
517,1.820612,546,268732,59.63,1265.48
518,2.825037,353,269085,59.61,1265.48
519,1.826142,545,269630,59.71,1265.77
520,2.156751,462,270092,59.87,1265.83
521,1.756682,567,270659,60.08,1341.61
522,1.754490,567,271226,60.07,1341.61
523,1.765837,564,271790,60.05,1341.61
524,1.782789,558,272348,60.04,1341.61
525,1.775011,561,272909,60.03,1341.61
526,1.814358,549,273458,60.02,1341.61
527,1.805169,551,274009,60.02,1341.61
528,1.894688,525,274534,60.01,1341.61
529,1.888970,527,275061,60.01,1341.61
530,1.906653,522,275583,60.00,1341.61
531,1.780940,558,276141,59.98,1341.61
532,2.173734,458,276599,59.97,1341.61
533,2.176950,458,277057,59.96,1341.61
534,2.244034,425,277482,59.95,1341.61
535,2.807763,369,277851,59.93,1341.61
536,1.849727,539,278390,59.92,1341.61
537,1.838543,541,278931,59.91,1341.61
538,2.646288,376,279307,59.90,1341.61
539,2.325147,428,279735,60.05,1341.61
540,2.183998,457,280192,60.32,1341.61
541,1.868603,532,280724,60.46,1344.43
542,1.786659,557,281281,60.45,1344.43
543,1.788269,556,281837,60.43,1344.43
544,1.759209,566,282403,60.42,1344.43
545,1.788289,557,282960,60.40,1344.43
546,1.789404,556,283516,60.38,1344.43
547,1.777260,560,284076,60.37,1344.43
548,1.799816,552,284628,60.35,1344.43
549,1.771692,562,285190,60.34,1344.43
550,1.827753,545,285735,60.32,1344.43
551,1.818258,547,286282,60.30,1344.43
552,1.824344,546,286828,60.29,1344.43
553,1.755924,566,287394,60.27,1344.43
554,1.745558,570,287964,60.25,1344.43
555,2.691819,370,288334,60.23,1344.43
556,1.781708,558,288892,60.19,1344.43
557,2.388347,417,289309,60.19,1344.43
558,2.019642,493,289802,60.32,1344.43
559,1.787108,556,290358,60.56,1344.64
560,1.762306,564,290922,60.64,1347.45
561,1.816347,548,291470,60.63,1347.45
562,1.937353,514,291984,60.61,1347.45
563,1.945869,511,292495,60.60,1347.45
564,1.936964,514,293009,60.59,1347.45
565,1.958386,508,293517,60.59,1347.45
566,1.955145,508,294025,60.57,1347.45
567,1.947388,512,294537,60.57,1347.45
568,1.931627,516,295053,60.55,1347.45
569,1.976849,504,295557,60.54,1347.45
570,3.025501,329,295886,60.54,1347.45
571,2.001620,498,296384,60.49,1347.45
572,1.862703,535,296919,60.47,1347.45
573,1.765965,563,297482,60.45,1347.45
574,1.756778,567,298049,60.44,1347.45
575,1.756823,566,298615,60.42,1347.45
576,2.980108,335,298950,60.41,1347.45
577,1.743159,571,299521,60.52,1347.45
578,2.080192,478,299999,60.76,1347.52
579,1.801259,554,300553,60.99,1350.25
580,1.755501,567,301120,60.97,1350.25
581,1.753364,568,301688,60.96,1350.25
582,1.739035,572,302260,60.94,1350.25
583,1.749332,567,302827,60.93,1350.25
584,1.734676,573,303400,60.92,1350.25
585,1.825033,545,303945,60.90,1350.25
586,1.837228,541,304486,60.90,1350.25
587,1.924336,517,305003,60.89,1350.25
588,1.899797,524,305527,60.88,1350.25
589,1.955839,509,306036,60.87,1350.25
590,2.793953,328,306364,60.86,1350.25
591,2.083588,516,306880,60.82,1350.25
592,2.125325,468,307348,60.80,1350.25
593,2.270384,439,307787,60.78,1350.34
594,2.197528,453,308240,60.77,1350.34
595,1.931278,515,308755,60.76,1350.34
596,3.139663,317,309072,60.77,1350.34
597,1.924992,517,309589,60.92,1350.34
598,2.422110,412,310001,61.09,1364.67
599,1.860712,534,310535,61.29,1407.25
600,1.853226,537,311072,61.28,1407.25
601,1.881624,529,311601,61.27,1407.25
602,1.798092,553,312154,61.25,1407.25
603,1.775676,561,312715,61.24,1407.25
604,1.779724,559,313274,61.22,1407.25
605,1.788361,556,313830,61.21,1407.25
606,1.810955,550,314380,61.19,1407.25
607,1.827881,544,314924,61.18,1407.25
608,1.830194,543,315467,61.17,1407.25
609,1.802795,552,316019,61.15,1407.25
610,1.804083,495,316514,61.14,1407.25
611,2.796355,393,316907,61.09,1407.25
612,1.860455,534,317441,61.07,1407.25
613,1.870280,532,317973,61.05,1407.25
614,1.765691,563,318536,61.03,1407.25
615,3.292437,303,318839,61.02,1407.25
616,1.809981,549,319388,61.12,1407.25
617,2.122769,470,319858,61.29,1416.80
618,2.052274,485,320343,61.51,1416.98
619,1.775036,560,320903,61.52,1416.98
620,1.798190,553,321456,61.51,1416.98
621,1.829556,544,322000,61.49,1416.98
622,1.968631,506,322506,61.48,1416.98
623,2.038195,488,322994,61.47,1416.98
624,1.914677,520,323514,61.46,1416.98
625,1.953732,509,324023,61.45,1416.98
626,2.183269,456,324479,61.45,1416.98
627,1.985801,502,324981,61.44,1416.98
628,1.967545,506,325487,61.43,1416.98
629,1.956658,509,325996,61.42,1416.98
630,1.950711,510,326506,61.41,1416.98
631,3.140014,318,326824,61.39,1416.98
632,1.807825,550,327374,61.35,1416.98
633,1.769213,562,327936,61.34,1416.98
634,1.777572,560,328496,61.31,1416.98
635,2.587627,385,328881,61.30,1416.98
636,1.823844,524,329405,61.39,1416.98
637,1.978983,522,329927,61.59,1417.36
638,2.159919,460,330387,61.80,1461.34
639,1.753419,567,330954,61.80,1461.34
640,1.758511,565,331519,61.79,1461.34
641,1.723369,576,332095,61.77,1461.34
642,1.746073,570,332665,61.76,1461.34
643,1.739467,572,333237,61.75,1461.34
644,1.743801,571,333808,61.73,1461.34
645,1.817842,547,334355,61.72,1461.34
646,1.840356,541,334896,61.71,1461.34
647,1.882398,529,335425,61.70,1461.34
648,1.889854,527,335952,61.70,1461.34
649,2.089571,476,336428,61.68,1461.34
650,1.838763,541,336969,61.67,1461.34
651,3.152284,316,337285,61.66,1461.34
652,2.244949,444,337729,61.61,1461.34
653,2.244949,444,338173,61.60,1461.34
654,2.176091,458,338631,61.58,1461.34
655,2.851492,349,338980,61.61,1461.34
656,2.208955,451,339431,61.73,1461.34
657,2.029397,468,339899,61.93,1462.02
658,2.122859,490,340389,62.13,1507.53
659,1.873946,531,340920,62.11,1507.53
660,1.881978,528,341448,62.10,1507.53
661,1.893934,525,341973,62.09,1507.53
662,1.839636,541,342514,62.08,1507.53
663,1.836113,542,343056,62.07,1507.53
664,1.867201,533,343589,62.05,1507.53
665,1.852276,537,344126,62.03,1507.53
666,1.831840,543,344669,62.01,1507.53
667,1.824538,545,345214,62.00,1507.53
668,1.881101,529,345743,61.98,1507.53
669,1.883590,528,346271,61.96,1507.53
670,1.768860,563,346834,61.93,1507.53
671,1.915464,445,347279,61.92,1507.53
672,2.737826,416,347695,61.87,1507.53
673,1.874214,531,348226,61.85,1507.53
674,1.817929,441,348667,61.83,1507.53
675,2.684645,443,349110,61.88,1507.53
676,2.087758,478,349588,62.04,1507.59
677,2.282661,436,350024,62.19,1507.75
678,1.763346,564,350588,62.35,1572.07
679,1.757221,566,351154,62.34,1572.07
680,1.758590,566,351720,62.33,1572.07
681,1.764762,563,352283,62.31,1572.07
682,1.926823,516,352799,62.29,1572.07
683,1.969639,507,353306,62.29,1572.07
684,1.921440,518,353824,62.28,1572.07
685,1.894839,525,354349,62.27,1572.07
686,1.938213,513,354862,62.26,1572.07
687,1.926384,517,355379,62.24,1572.07
688,1.999019,498,355877,62.23,1572.07
689,1.983272,501,356378,62.21,1572.07
690,2.032216,491,356869,62.19,1572.07
691,1.909359,522,357391,62.18,1572.07
692,3.224972,309,357700,62.14,1572.07
693,1.741874,571,358271,62.12,1572.07
694,2.529251,394,358665,62.11,1572.07
695,1.744082,569,359234,62.19,1572.07
696,2.033660,489,359723,62.38,1575.81
697,2.348015,424,360147,62.53,1623.80
698,1.770289,562,360709,62.61,1623.80
699,1.758062,565,361274,62.60,1623.80
700,1.744290,571,361845,62.58,1623.80
701,1.762949,564,362409,62.57,1623.80
702,1.770284,562,362971,62.56,1623.80
703,1.769226,561,363532,62.54,1623.80
704,1.763641,564,364096,62.53,1623.80
705,1.792130,555,364651,62.52,1623.80
706,1.815573,548,365199,62.51,1623.80
707,1.819572,546,365745,62.50,1623.80
708,1.863913,535,366280,62.49,1623.80
709,1.807941,550,366830,62.47,1623.80
710,2.042436,487,367317,62.45,1623.80
711,1.816578,548,367865,62.44,1623.80
712,4.103584,243,368108,62.43,1623.80
713,2.250044,443,368551,62.39,1623.80
714,3.327362,300,368851,62.42,1623.80
715,2.099174,474,369325,62.54,1623.80
716,2.251964,443,369768,62.73,1623.88
717,2.213668,450,370218,62.90,1800.81
718,1.971208,505,370723,62.89,1800.81
719,1.965329,506,371229,62.88,1800.81
720,1.890627,526,371755,62.86,1800.81
721,1.924103,517,372272,62.85,1800.81
722,1.832318,543,372815,62.84,1800.81
723,1.849272,538,373353,62.82,1800.81
724,1.837930,542,373895,62.80,1800.81
725,1.835400,543,374438,62.79,1800.81
726,1.820290,546,374984,62.77,1800.81
727,1.984699,444,375428,62.75,1800.81
728,3.070625,362,375790,62.70,1800.81
729,1.871011,521,376311,62.68,1800.81
730,2.012769,504,376815,62.68,1800.81
731,1.787521,556,377371,62.66,1800.81
732,1.793027,555,377926,62.64,1800.81
733,1.758938,566,378492,62.63,1800.81
734,2.715152,367,378859,62.66,1800.89
735,1.999308,494,379353,62.77,1800.89
736,1.820373,552,379905,62.96,1801.47
737,2.116149,470,380375,63.16,1801.52
738,1.749368,570,380945,63.15,1801.52
739,1.741068,572,381517,63.13,1801.52
740,1.760942,565,382082,63.12,1801.52
741,1.842519,540,382622,63.10,1801.52
742,1.938946,514,383136,63.09,1801.52
743,1.944415,512,383648,63.08,1801.52
744,2.005043,497,384145,63.07,1801.52
745,1.936705,514,384659,63.06,1801.52
746,1.935681,514,385173,63.05,1801.52
747,1.946758,511,385684,63.04,1801.52
748,3.918155,255,385939,63.00,1801.52
749,1.939708,513,386452,62.98,1801.52
750,1.987246,501,386953,62.97,1801.52
751,1.916368,520,387473,62.95,1801.52
752,1.755080,566,388039,62.94,1801.52
753,1.762123,473,388512,62.93,1801.52
754,2.345614,494,389006,62.99,1801.56
755,1.814899,548,389554,63.13,1801.56
756,2.103874,473,390027,63.28,1801.65
757,1.813101,549,390576,63.40,1818.31
758,1.780103,559,391135,63.41,1818.31
759,1.760875,565,391700,63.39,1818.31
760,1.760159,566,392266,63.38,1818.31
761,1.729731,575,392841,63.36,1818.31
762,1.741583,571,393412,63.35,1818.31
763,1.731654,574,393986,63.34,1818.31
764,1.702711,584,394570,63.32,1818.31
765,1.788000,556,395126,63.31,1818.31
766,1.822844,546,395672,63.30,1818.31
767,1.897305,524,396196,63.29,1818.31
768,2.964995,310,396506,63.28,1818.31
769,2.388193,450,396956,63.23,1818.31
770,1.857937,534,397490,63.22,1818.31
771,2.164690,460,397950,63.20,1818.31
772,2.182395,456,398406,63.18,1818.31
773,3.323974,300,398706,63.22,1818.36
774,2.523288,395,399101,63.35,1818.36
775,2.195831,454,399555,63.54,1818.36
776,2.613407,381,399936,63.69,1823.99
777,1.836197,541,400477,63.73,1826.72
778,1.820676,548,401025,63.72,1826.72
779,1.866095,533,401558,63.71,1826.72
780,1.880556,529,402087,63.70,1826.72
781,1.962952,507,402594,63.69,1826.72
782,1.791299,556,403150,63.67,1826.72
783,1.863486,533,403683,63.66,1826.72
784,1.818444,547,404230,63.64,1826.72
785,1.794068,555,404785,63.62,1826.72
786,1.808550,550,405335,63.60,1826.72
787,1.812629,549,405884,63.58,1826.72
788,1.849887,530,406414,63.57,1826.72
789,3.745001,270,406684,63.52,1826.72
790,1.874862,531,407215,63.50,1826.72
791,1.827766,545,407760,63.48,1826.72
792,1.764915,563,408323,63.46,1826.72
793,2.596900,384,408707,63.49,1826.72
794,2.016791,494,409201,63.59,1826.72
795,1.784589,558,409759,63.73,1826.74
796,2.813781,351,410110,63.92,1936.08
797,1.987494,506,410616,64.03,2046.88
798,1.762766,564,411180,64.02,2046.88
799,1.784084,557,411737,64.01,2046.88
800,1.813576,548,412285,64.00,2046.88
801,1.787621,556,412841,63.98,2046.88
802,1.946172,511,413352,63.97,2046.88
803,2.000590,497,413849,63.96,2046.88
804,1.934056,515,414364,63.95,2046.88
805,1.939740,513,414877,63.93,2046.88
806,1.997801,499,415376,63.93,2046.88
807,1.953187,509,415885,63.93,2046.88
808,1.906149,522,416407,63.91,2046.88
809,4.343197,230,416637,63.89,2046.88
810,2.027537,490,417127,63.85,2046.88
811,1.915899,519,417646,63.83,2046.88
812,1.753341,568,418214,63.82,2046.88
813,2.870630,347,418561,63.82,2046.88
814,1.741853,570,419131,63.90,2046.88
815,2.228172,447,419578,64.00,2073.54
816,2.042139,481,420059,64.22,2073.54
817,2.024482,497,420556,64.32,2324.45
818,1.733754,574,421130,64.32,2324.45
819,1.743784,570,421700,64.31,2324.45
820,1.754094,567,422267,64.30,2324.45
821,1.745331,570,422837,64.28,2324.45
822,1.764031,564,423401,64.27,2324.45
823,1.769639,562,423963,64.25,2324.45
824,1.773296,561,424524,64.24,2324.45
825,1.859526,535,425059,64.23,2324.45
826,1.906127,522,425581,64.22,2324.45
827,2.272456,419,426000,64.20,2324.45
828,1.952072,532,426532,64.21,2324.45
829,2.109600,433,426965,64.20,2324.45
830,3.374070,320,427285,64.16,2324.45
831,1.865011,534,427819,64.13,2324.45
832,2.111017,472,428291,64.12,2324.45
833,3.524602,283,428574,64.14,2324.45
834,2.132466,467,429041,64.24,2324.45
835,2.233129,446,429487,64.37,2350.60
836,2.065667,451,429938,64.51,2350.94
837,2.491248,426,430364,64.63,2408.19
838,1.953601,509,430873,64.62,2408.19
839,1.915906,520,431393,64.61,2408.19
840,1.890018,526,431919,64.60,2408.19
841,1.875709,530,432449,64.59,2408.19
842,1.786846,557,433006,64.58,2408.19
843,1.781911,558,433564,64.57,2408.19
844,1.807444,550,434114,64.55,2408.19
845,1.812907,549,434663,64.54,2408.19
846,1.816851,547,435210,64.52,2408.19
847,1.827229,544,435754,64.51,2408.19
848,1.873461,532,436286,64.49,2408.19
849,1.798158,553,436839,64.47,2408.19
850,4.263881,234,437073,64.43,2408.19
851,1.837775,542,437615,64.40,2408.19
852,1.829603,544,438159,64.38,2408.19
853,3.562642,280,438439,64.42,2417.25
854,1.848267,538,438977,64.50,2417.25
855,2.077207,476,439453,64.59,2443.27
856,1.943577,516,439969,64.76,2443.27
857,2.295573,434,440403,64.88,2443.35
858,1.777819,560,440963,64.92,2448.81
859,1.788468,556,441519,64.90,2448.81
860,1.782734,558,442077,64.89,2448.81
861,1.839313,542,442619,64.87,2448.81
862,1.949334,511,443130,64.86,2448.81
863,1.965945,507,443637,64.85,2448.81
864,2.212226,450,444087,64.86,2448.81
865,1.998550,497,444584,64.85,2448.81
866,1.986358,501,445085,64.84,2448.81
867,1.966390,507,445592,64.83,2448.81
868,2.059794,483,446075,64.81,2448.81
869,1.950715,511,446586,64.80,2448.81
870,2.615116,371,446957,64.78,2448.81
871,2.798455,365,447322,64.74,2448.81
872,1.762698,564,447886,64.71,2448.81
873,1.744157,393,448279,64.70,2448.81
874,2.835930,460,448739,64.76,2448.81
875,1.774383,561,449300,64.90,2448.81
876,2.268538,439,449739,65.02,2448.81
877,1.936546,514,450253,65.20,2449.74
878,1.794839,554,450807,65.26,2449.74
879,1.768242,562,451369,65.24,2449.74
880,1.883531,527,451896,65.23,2449.74
881,1.759016,567,452463,65.24,2449.74
882,1.735009,573,453036,65.22,2449.74
883,1.718573,578,453614,65.21,2449.74
884,1.764229,564,454178,65.19,2449.74
885,1.802516,552,454730,65.19,2449.74
886,1.840067,541,455271,65.17,2449.74
887,1.867159,532,455803,65.17,2449.74
888,1.839388,541,456344,65.16,2449.74
889,2.160607,461,456805,65.14,2449.74
890,1.855052,537,457342,65.13,2449.74
891,4.940837,202,457544,65.09,2449.74
892,2.279404,437,457981,65.06,2449.74
893,2.390327,259,458240,65.05,2449.74
894,3.650863,376,458616,65.12,2449.74
895,2.093557,475,459091,65.20,2449.76
896,2.852179,349,459440,65.34,2449.76
897,2.179832,439,459879,65.43,2449.84
898,2.346984,441,460320,65.61,2493.61
899,1.866192,533,460853,65.59,2493.61
900,1.870015,532,461385,65.58,2493.61
901,1.934794,515,461900,65.57,2493.61
902,1.791603,555,462455,65.55,2493.61
903,1.804422,552,463007,65.54,2493.61
904,1.809985,550,463557,65.53,2493.61
905,1.781565,559,464116,65.51,2493.61
906,1.770950,561,464677,65.49,2493.61
907,1.803915,551,465228,65.48,2493.61
908,1.897146,524,465752,65.46,2493.61
909,1.884632,528,466280,65.44,2493.61
910,1.847483,539,466819,65.41,2493.61
911,2.177538,385,467204,65.39,2493.61
912,2.912577,396,467600,65.35,2493.61
913,1.778263,559,468159,65.33,2493.61
914,3.532956,282,468441,65.34,2493.61
915,1.798753,553,468994,65.42,2502.49
916,1.835952,542,469536,65.50,2509.59
917,2.416902,412,469948,65.66,2537.07
918,1.823570,547,470495,65.79,2537.22
919,1.727515,576,471071,65.81,2537.22
920,1.775846,561,471632,65.82,2537.22
921,1.814096,548,472180,65.81,2537.22
922,1.929661,515,472695,65.79,2537.22
923,1.957051,507,473202,65.79,2537.22
924,1.934928,514,473716,65.78,2537.22
925,1.971552,506,474222,65.76,2537.22
926,1.981692,501,474723,65.75,2537.22
927,2.011513,495,475218,65.74,2537.22
928,2.048150,486,475704,65.73,2537.22
929,1.987709,501,476205,65.71,2537.22
930,2.065599,482,476687,65.69,2537.22
931,1.891385,526,477213,65.67,2537.22
932,4.816045,207,477420,65.64,2537.22
933,1.764735,564,477984,65.61,2537.22
934,3.863563,258,478242,65.61,2537.22
935,1.762311,564,478806,65.67,2537.22
936,1.746766,569,479375,65.75,2537.22
937,2.329471,428,479803,65.90,2537.22
938,2.009540,493,480296,66.04,2537.38
939,1.917148,521,480817,66.11,2537.38
940,1.751934,568,481385,66.10,2537.38
941,1.748006,569,481954,66.08,2537.38
942,1.764445,564,482518,66.07,2537.38
943,1.768417,563,483081,66.08,2537.38
944,1.746627,569,483650,66.07,2537.38
945,1.831514,544,484194,66.05,2537.38
946,1.904084,523,484717,66.04,2537.38
947,1.912874,520,485237,66.03,2537.38
948,1.993428,499,485736,66.02,2537.38
949,1.879088,529,486265,66.03,2537.38
950,1.927484,517,486782,66.01,2537.38
951,2.128940,468,487250,65.99,2537.38
952,2.947983,324,487574,65.97,2537.38
953,3.545275,293,487867,65.93,2537.38
954,2.199674,254,488121,65.93,2537.38
955,3.108727,462,488583,65.98,2537.38
956,1.883907,528,489111,66.06,2537.38
957,2.302361,433,489544,66.18,2537.38
958,1.983157,502,490046,66.35,2537.64
959,1.845511,539,490585,66.40,2537.64
960,1.853699,537,491122,66.39,2537.64
961,1.925449,516,491638,66.38,2537.64
962,1.832003,544,492182,66.37,2537.64
963,1.776317,560,492742,66.35,2537.64
964,1.774294,561,493303,66.34,2537.64
965,2.202627,452,493755,66.35,2537.64
966,1.774481,561,494316,66.33,2537.64
967,1.776116,560,494876,66.31,2537.64
968,1.803030,552,495428,66.30,2537.64
969,1.808101,551,495979,66.28,2537.64
970,1.905647,522,496501,66.27,2537.64
971,1.908345,520,497021,66.25,2537.64
972,1.990209,501,497522,66.24,2537.64
973,5.399800,185,497707,66.23,2537.64
974,1.722887,375,498082,66.18,2537.64
975,2.946464,457,498539,66.23,2537.64
976,1.741284,572,499111,66.30,2537.64
977,2.191898,455,499566,66.37,2537.64
978,1.876818,434,,,
