second,avg_latency_ms_consul_v0.6.4,throughput_consul_v0.6.4,cumulative_throughput_consul_v0.6.4,avg_cpu_consul_v0.6.4,avg_memory_mb_consul_v0.6.4
0,4.555991,125,125,2.13,16.82
1,4.584714,218,343,5.22,17.74
2,4.381011,228,571,7.50,18.41
3,4.412867,226,797,9.21,18.97
4,4.623517,216,1013,10.56,19.46
5,4.554978,220,1233,11.74,19.83
6,4.627884,216,1449,12.77,20.13
7,4.602018,217,1666,13.59,20.61
8,4.835867,206,1872,14.40,21.20
9,4.679823,213,2085,15.09,21.69
10,4.563140,220,2305,15.73,20.95
11,4.589883,217,2522,16.19,22.18
12,4.566273,219,2741,16.64,22.63
13,4.670575,214,2955,17.02,23.10
14,4.578362,218,3173,17.44,23.27
15,4.584843,218,3391,17.80,24.25
16,4.679429,214,3605,18.13,24.77
17,4.729577,211,3816,18.37,25.37
18,4.946025,201,4017,18.60,26.08
19,5.964697,168,4185,18.84,24.29
20,5.811998,172,4357,19.12,24.67
21,5.793856,172,4529,19.43,25.19
22,5.851281,171,4700,19.69,25.39
23,5.884489,170,4870,19.96,25.56
24,5.837966,171,5041,20.22,26.73
25,5.840602,171,5212,20.42,27.61
26,6.244181,160,5372,20.64,28.12
27,6.128122,163,5535,20.84,28.56
28,5.469167,183,5718,21.02,28.73
29,4.634086,216,5934,21.16,29.26
30,4.483235,222,6156,21.23,30.23
31,4.455500,225,6381,21.32,30.57
32,4.554925,219,6600,21.43,30.83
33,4.568305,219,6819,21.51,31.27
34,4.660145,214,7033,21.59,31.70
35,4.693283,213,7246,21.68,32.58
36,4.787186,209,7455,21.77,33.01
37,4.579569,218,7673,21.85,33.35
38,4.561225,219,7892,21.91,33.61
39,4.643179,215,8107,22.01,34.40
40,4.648970,215,8322,22.05,30.47
41,4.633328,216,8538,22.11,30.92
42,4.445673,225,8763,22.17,31.42
43,4.437254,225,8988,22.24,31.82
44,4.603601,216,9204,22.31,32.27
45,4.459342,225,9429,22.38,32.75
46,4.478697,223,9652,22.39,33.19
47,4.573845,219,9871,22.46,33.99
48,4.462784,224,10095,22.53,34.51
49,4.570233,218,10313,22.59,35.14
50,4.722910,211,10524,22.62,35.49
51,4.711019,212,10736,22.66,35.84
52,4.707546,213,10949,22.73,36.29
53,4.682046,214,11163,22.82,37.08
54,4.698476,212,11375,22.91,37.34
55,4.872165,205,11580,23.00,37.96
56,4.637559,216,11796,23.07,38.14
57,4.600993,216,12012,23.18,38.58
58,4.621088,217,12229,23.26,39.28
59,4.553836,220,12449,23.36,39.80
60,4.540756,219,12668,23.45,40.32
61,4.582308,219,12887,23.52,40.85
62,4.506297,222,13109,23.55,41.82
63,4.460232,224,13333,23.57,42.34
64,4.477415,223,13556,23.61,42.69
65,4.552074,220,13776,23.64,43.04
66,4.483294,223,13999,23.66,43.83
67,4.436979,225,14224,23.69,44.27
68,4.476823,223,14447,23.71,44.71
69,4.520991,221,14668,23.74,44.98
70,4.482901,223,14891,23.75,45.24
71,4.429726,226,15117,23.77,45.77
72,4.382470,227,15344,23.79,46.39
73,4.443176,226,15570,23.82,46.93
74,4.336280,230,15800,23.83,47.27
75,4.368029,229,16029,23.84,48.06
76,4.407322,227,16256,23.88,40.54
77,4.544211,220,16476,23.89,40.72
78,4.967010,201,16677,23.89,41.09
79,5.807285,172,16849,23.92,41.56
80,5.959931,168,17017,23.96,41.66
81,5.711982,175,17192,24.00,42.20
82,5.875639,170,17362,24.04,42.76
83,5.796367,172,17534,24.06,43.15
84,5.859216,171,17705,24.08,43.85
85,6.010396,166,17871,24.09,44.38
86,6.051391,165,18036,24.13,44.64
87,6.090080,164,18200,24.17,44.99
88,5.347539,187,18387,24.20,45.24
89,4.524169,220,18607,24.22,45.77
90,4.560523,220,18827,24.22,46.04
91,4.553422,220,19047,24.23,46.73
92,4.439992,225,19272,24.24,47.43
93,4.438445,225,19497,24.25,47.87
94,4.509667,221,19718,24.26,48.22
95,4.497508,222,19940,24.26,48.48
96,4.530745,220,20160,24.26,48.92
97,4.481486,224,20384,24.27,49.62
98,4.440751,225,20609,24.28,49.80
99,4.419110,226,20835,24.28,50.42
100,4.426124,226,21061,24.30,51.03
101,4.475066,223,21284,24.30,51.30
102,4.477643,223,21507,24.30,51.91
103,4.691460,213,21720,24.32,52.52
104,4.824532,207,21927,24.32,53.39
105,4.494690,223,22150,24.32,53.48
106,4.399900,227,22377,24.33,54.01
107,4.395017,227,22604,24.33,54.44
108,4.437134,224,22828,24.32,54.98
109,4.542883,220,23048,24.33,55.42
110,4.559596,220,23268,24.34,55.95
111,4.560446,219,23487,24.34,56.38
112,4.606131,217,23704,24.39,57.25
113,4.559824,219,23923,24.43,57.60
114,4.467599,224,24147,24.47,58.21
115,4.426258,225,24372,24.51,58.83
116,4.420609,227,24599,24.53,59.09
117,4.508375,221,24820,24.57,59.62
118,4.483560,223,25043,24.66,65.89
119,4.557119,220,25263,24.73,68.27
120,4.551099,219,25482,24.78,68.45
121,4.465954,224,25706,24.84,68.80
122,4.268799,234,25940,24.87,68.98
123,4.342267,230,26170,24.90,69.24
124,4.260950,234,26404,24.93,69.50
125,4.253449,236,26640,24.96,70.12
126,4.178681,239,26879,25.00,70.82
127,4.332401,231,27110,25.00,71.35
128,4.297388,232,27342,25.03,71.69
129,4.149152,241,27583,25.07,71.86
130,4.240295,236,27819,25.08,72.04
131,4.241063,235,28054,25.11,72.56
132,4.196043,239,28293,25.13,72.83
133,4.216759,237,28530,25.15,73.10
134,4.061724,246,28776,25.18,73.63
135,4.147650,240,29016,25.20,73.80
136,4.278902,234,29250,25.22,74.42
137,4.246278,236,29486,25.24,74.77
138,4.641933,214,29700,25.26,74.95
139,5.480460,183,29883,25.28,75.47
140,5.502711,181,30064,25.29,76.08
141,5.522762,182,30246,25.34,76.43
142,5.392109,185,30431,25.37,76.87
143,5.458219,183,30614,25.37,77.32
144,5.475320,182,30796,25.41,77.57
145,5.518572,182,30978,25.41,77.93
146,5.360752,186,31164,25.45,78.37
147,5.547179,180,31344,25.47,78.46
148,5.016594,200,31544,25.49,78.72
149,4.148178,240,31784,25.52,79.34
150,4.187814,239,32023,25.52,79.42
151,4.117143,243,32266,25.55,79.69
152,4.126625,242,32508,25.57,69.24
153,4.067665,246,32754,25.57,69.64
154,3.989692,250,33004,25.58,70.01
155,4.169487,240,33244,25.60,70.11
156,4.158524,240,33484,25.63,70.37
157,4.200516,238,33722,25.65,71.16
158,4.061068,246,33968,25.64,71.51
159,4.096968,244,34212,25.66,72.04
160,4.165160,240,34452,25.68,72.74
161,4.317763,231,34683,25.69,73.00
162,4.200591,239,34922,25.69,73.43
163,4.228699,236,35158,25.71,74.14
164,4.198145,238,35396,25.71,74.14
165,4.127682,242,35638,25.73,75.01
166,4.002948,250,35888,25.73,75.27
167,4.101558,243,36131,25.74,75.62
168,4.191713,239,36370,25.76,75.97
169,4.120815,243,36613,25.77,76.50
170,4.122242,242,36855,25.76,76.76
171,4.261165,235,37090,25.77,77.38
172,4.392800,227,37317,25.81,77.99
173,4.354912,230,37547,25.83,78.56
174,4.477919,223,37770,25.87,79.25
175,4.430679,225,37995,25.88,79.52
176,4.350035,230,38225,25.90,79.69
177,4.350183,230,38455,25.94,80.31
178,4.356168,230,38685,25.95,80.66
179,4.482118,223,38908,25.98,81.01
180,4.380146,228,39136,26.00,81.62
181,4.462027,223,39359,26.03,82.06
182,4.133914,243,39602,26.03,82.33
183,4.572125,218,39820,26.03,82.86
184,4.349183,230,40050,26.04,83.56
185,4.421204,226,40276,26.01,83.91
186,4.605697,217,40493,26.03,84.62
187,4.625985,216,40709,26.02,85.06
188,4.453704,225,40934,26.02,85.50
189,4.496077,222,41156,26.02,85.68
190,4.378444,228,41384,26.01,86.30
191,4.421552,226,41610,26.01,86.66
192,4.471552,224,41834,26.01,87.35
193,4.754847,209,42043,26.00,87.89
194,4.518971,222,42265,26.06,99.23
195,4.289669,233,42498,26.09,106.01
196,4.286650,233,42731,26.12,106.18
197,4.368305,229,42960,26.14,107.07
198,4.685064,214,43174,26.15,107.42
199,5.702197,175,43349,26.17,107.77
200,5.672293,176,43525,26.20,108.21
201,5.695372,176,43701,26.23,108.74
202,5.625708,177,43878,26.24,108.91
203,5.803489,172,44050,26.27,109.53
204,5.537474,181,44231,26.28,109.61
205,5.596424,179,44410,26.31,109.88
206,5.710921,175,44585,26.35,110.06
207,5.723848,174,44759,26.37,110.33
208,5.165589,194,44953,26.40,110.67
209,4.268900,234,45187,26.42,111.03
210,4.126219,242,45429,26.44,111.03
211,4.272862,234,45663,26.47,111.47
212,4.170292,240,45903,26.47,111.82
213,4.232884,236,46139,26.50,112.08
214,4.248250,235,46374,26.52,112.52
215,4.259260,235,46609,26.53,112.79
216,4.219174,237,46846,26.54,113.15
217,4.201488,238,47084,26.56,102.80
218,4.212682,237,47321,26.58,103.15
219,4.304773,232,47553,26.60,103.59
220,4.087435,245,47798,26.62,104.03
221,4.249404,235,48033,26.65,104.59
222,4.142350,241,48274,26.64,104.67
223,4.284913,234,48508,26.68,105.29
224,4.207400,237,48745,26.68,105.47
225,4.351279,229,48974,26.72,106.10
226,4.884505,205,49179,26.78,123.08
227,4.559298,220,49399,26.83,124.93
228,4.381352,228,49627,26.86,124.93
229,4.403808,227,49854,26.89,125.20
230,4.370239,229,50083,26.92,125.20
231,4.524006,221,50304,26.94,125.28
232,4.695674,212,50516,26.98,125.64
233,4.843917,207,50723,27.01,126.07
234,4.766328,209,50932,27.06,126.25
235,4.809437,208,51140,27.09,126.25
236,5.084614,197,51337,27.13,126.69
237,4.898146,204,51541,27.18,126.87
238,4.677922,213,51754,27.19,127.04
239,4.671663,214,51968,27.22,127.22
240,4.736283,211,52179,27.26,127.31
241,4.603900,217,52396,27.30,127.49
242,4.439608,226,52622,27.32,127.49
243,4.366058,226,52848,27.36,128.10
244,4.636046,218,53066,27.38,128.19
245,4.391094,228,53294,27.39,128.19
246,4.432393,225,53519,27.43,128.36
247,4.451787,225,53744,27.45,128.45
248,4.432593,225,53969,27.49,128.72
249,4.484218,223,54192,27.51,128.72
250,4.321883,231,54423,27.54,129.16
251,4.382954,228,54651,27.55,129.16
252,4.397947,227,54878,27.57,129.69
253,4.417790,227,55105,27.60,129.95
254,4.296468,232,55337,27.61,130.15
255,4.332277,231,55568,27.64,130.15
256,4.205935,238,55806,27.65,130.24
257,4.401501,227,56033,27.68,130.50
258,4.676345,214,56247,27.69,130.68
259,5.758134,173,56420,27.69,130.77
260,5.531669,181,56601,27.73,131.03
261,5.620367,178,56779,27.74,131.03
262,5.700725,175,56954,27.76,131.12
263,5.531821,181,57135,27.80,131.31
264,5.469765,183,57318,27.83,131.50
265,5.638620,177,57495,27.83,131.50
266,5.949013,168,57663,27.85,131.50
267,5.693999,176,57839,27.89,131.67
268,5.655291,176,58015,27.91,131.76
269,4.528558,221,58236,27.92,131.94
270,4.332178,231,58467,27.96,132.46
271,4.473966,223,58690,27.96,132.46
272,4.304634,233,58923,27.99,133.08
273,4.439825,225,59148,28.00,133.26
274,4.394246,226,59374,28.02,133.43
275,4.381185,229,59603,28.05,133.69
276,4.389875,228,59831,28.06,133.86
277,4.739711,211,60042,28.09,134.13
278,4.348666,230,60272,28.09,134.47
279,4.542736,220,60492,28.10,134.47
280,4.353018,229,60721,28.12,134.65
281,4.495422,222,60943,28.12,134.74
282,4.455370,225,61168,28.14,135.00
283,4.358466,229,61397,28.15,135.18
284,4.294547,233,61630,28.16,135.27
285,4.243028,235,61865,28.19,135.80
286,4.228877,236,62101,28.19,135.97
287,4.283384,234,62335,28.21,136.41
288,4.129606,242,62577,28.23,136.59
289,4.249657,235,62812,28.22,136.77
290,4.124877,242,63054,28.25,136.85
291,4.248787,235,63289,28.25,137.12
292,4.332675,231,63520,28.28,137.72
293,4.292437,233,63753,28.30,137.89
294,4.224870,236,63989,28.31,138.24
295,4.347442,230,64219,28.33,138.42
296,4.209764,238,64457,28.35,138.42
297,4.313244,231,64688,28.38,139.30
298,4.207501,238,64926,28.39,139.39
299,4.225610,236,65162,28.42,139.75
300,4.286110,234,65396,28.45,139.92
301,4.112167,243,65639,28.45,140.01
302,4.074650,245,65884,28.48,140.36
303,4.149655,240,66124,28.48,140.36
304,4.194964,239,66363,28.50,140.89
305,4.138555,242,66605,28.50,140.98
306,4.083044,244,66849,28.50,141.31
307,4.161311,240,67089,28.51,141.83
308,4.272608,234,67323,28.51,141.92
309,4.139223,242,67565,28.54,142.54
310,4.024960,248,67813,28.54,142.54
311,4.067224,246,68059,28.54,142.89
312,4.092244,244,68303,28.56,143.07
313,4.019463,249,68552,28.55,143.07
314,3.879310,258,68810,28.57,143.85
315,4.020329,248,69058,28.56,144.12
316,3.999506,250,69308,28.57,144.29
317,4.048866,247,69555,28.58,144.64
318,4.426103,226,69781,28.59,145.00
319,5.690890,175,69956,28.63,145.61
320,6.000404,167,70123,28.67,168.22
321,5.814176,172,70295,28.68,168.75
322,5.613780,178,70473,28.71,169.09
323,5.761673,174,70647,28.74,169.44
324,5.683736,175,70822,28.79,169.87
325,5.738487,175,70997,28.82,172.37
326,5.990122,166,71163,28.85,177.12
327,5.977216,168,71331,28.89,177.56
328,5.179875,193,71524,28.91,177.56
329,4.542016,220,71744,28.93,177.65
330,4.479181,223,71967,28.96,177.65
331,4.465716,224,72191,29.00,178.00
332,4.536529,220,72411,29.01,178.00
333,4.402220,227,72638,29.03,178.00
334,4.439787,225,72863,29.06,178.00
335,4.399873,228,73091,29.08,178.00
336,4.381454,228,73319,29.11,178.44
337,4.373037,228,73547,29.12,178.44
338,4.481772,223,73770,29.16,178.44
339,4.625599,216,73986,29.18,178.44
340,4.427974,226,74212,29.20,178.79
341,4.400857,227,74439,29.23,179.14
342,4.285987,234,74673,29.24,179.14
343,4.533102,220,74893,29.27,179.23
344,4.367405,229,75122,29.29,179.32
345,4.591827,218,75340,29.31,179.32
346,4.223952,236,75576,29.33,179.40
347,4.461711,224,75800,29.36,179.58
348,4.445319,225,76025,29.36,179.58
349,4.320704,229,76254,29.40,179.67
350,4.601365,219,76473,29.42,179.84
351,4.358905,230,76703,29.43,179.84
352,4.362145,229,76932,29.45,179.93
353,4.260647,234,77166,29.49,180.28
354,4.337017,231,77397,29.52,180.28
355,4.239060,236,77633,29.55,180.37
356,4.268256,234,77867,29.59,180.46
357,4.465467,224,78091,29.61,180.46
358,4.285103,233,78324,29.65,180.46
359,4.280670,234,78558,29.68,180.72
360,4.353201,229,78787,29.71,180.72
361,4.228252,236,79023,29.74,180.72
362,4.295112,233,79256,29.76,180.99
363,4.303368,233,79489,29.78,180.99
364,4.120981,242,79731,29.79,181.25
365,4.178561,239,79970,29.80,181.25
366,4.151925,241,80211,29.83,181.25
367,4.206485,238,80449,29.84,181.51
368,4.242688,235,80684,29.84,181.51
369,4.083155,245,80929,29.87,181.69
370,4.165250,240,81169,29.87,181.69
371,4.054784,246,81415,29.89,182.04
372,4.222024,237,81652,29.91,182.04
373,4.181787,239,81891,29.92,182.04
374,4.253970,235,82126,29.93,182.04
375,4.124751,242,82368,29.96,182.21
376,4.200807,238,82606,29.96,182.21
377,3.982255,251,82857,29.98,182.30
378,4.500328,222,83079,30.00,182.30
379,5.307962,189,83268,30.02,182.39
380,5.494742,181,83449,30.02,182.39
381,5.378423,186,83635,30.04,182.56
382,5.355809,187,83822,30.05,182.56
383,5.268486,190,84012,30.05,182.56
384,5.140505,194,84206,30.08,182.74
385,5.412654,185,84391,30.09,182.83
386,5.422116,184,84575,30.10,182.91
387,5.521667,181,84756,30.13,183.09
388,4.900533,204,84960,30.14,183.09
389,4.197650,238,85198,30.15,183.44
390,4.119041,243,85441,30.16,183.44
391,4.249049,235,85676,30.16,183.44
392,4.192315,239,85915,30.18,183.79
393,4.110894,243,86158,30.20,183.79
394,4.168611,239,86397,30.21,183.88
395,4.064884,246,86643,30.21,183.88
396,4.221934,237,86880,30.22,183.88
397,4.064383,246,87126,30.24,184.23
398,4.006011,249,87375,30.25,184.23
399,4.101869,244,87619,30.24,184.23
400,3.938152,254,87873,30.26,184.49
401,4.282383,233,88106,30.27,184.49
402,4.426630,226,88332,30.26,184.58
403,4.374613,228,88560,30.27,184.85
404,4.283674,233,88793,30.28,184.85
405,4.431550,226,89019,30.27,184.94
406,4.279661,233,89252,30.28,185.41
407,4.284192,233,89485,30.29,185.50
408,4.408854,227,89712,30.28,185.50
409,4.290306,233,89945,30.30,185.94
410,4.277071,234,90179,30.30,185.94
411,4.346060,230,90409,30.29,185.94
412,4.401793,227,90636,30.31,186.38
413,4.317371,231,90867,30.32,186.47
414,4.243787,236,91103,30.33,186.47
415,4.452271,224,91327,30.35,186.82
416,4.235872,236,91563,30.35,187.00
417,4.347049,230,91793,30.37,187.52
418,4.396529,227,92020,30.39,188.05
419,4.251335,235,92255,30.40,188.05
420,4.258142,235,92490,30.40,188.14
421,4.371449,229,92719,30.41,188.40
422,4.223108,236,92955,30.43,188.93
423,4.217754,237,93192,30.42,189.11
424,4.280255,234,93426,30.41,189.11
425,4.218182,237,93663,30.43,189.46
426,4.331357,230,93893,30.42,189.55
427,4.308198,232,94125,30.42,189.72
428,4.232283,237,94362,30.43,190.43
429,4.165860,240,94602,30.44,190.78
430,4.332819,230,94832,30.42,190.78
431,4.280864,234,95066,30.44,191.40
432,4.242740,235,95301,30.42,191.49
433,4.204447,238,95539,30.42,191.49
434,4.251786,235,95774,30.42,191.84
435,4.202448,238,96012,30.42,191.93
436,4.279835,234,96246,30.42,192.28
437,4.354941,229,96475,30.43,192.72
438,4.680080,213,96688,30.42,193.15
439,5.829648,172,96860,30.41,193.15
440,5.741573,174,97034,30.40,193.24
441,5.784395,173,97207,30.40,193.77
442,5.705702,175,97382,30.42,193.94
443,5.665365,176,97558,30.41,194.03
444,5.637202,178,97736,30.41,194.03
445,5.809154,171,97907,30.41,194.36
446,6.159703,163,98070,30.43,194.71
447,6.950205,144,98214,30.44,194.71
448,6.018647,166,98380,30.47,207.57
449,4.701266,212,98592,30.49,212.67
450,4.782753,209,98801,30.50,212.67
451,4.641344,216,99017,30.48,212.67
452,4.614122,216,99233,30.51,212.93
453,4.595828,218,99451,30.51,212.93
454,4.742450,211,99662,30.52,212.93
455,4.545191,220,99882,30.53,213.45
456,4.428391,225,100107,30.54,213.45
457,4.677197,214,100321,30.55,213.88
458,4.810205,208,100529,30.54,213.88
459,4.711630,212,100741,30.56,214.49
460,4.658340,214,100955,30.56,214.49
461,4.579695,219,101174,30.57,214.49
462,4.750675,210,101384,30.56,214.58
463,4.600670,217,101601,30.58,215.02
464,4.504474,222,101823,30.59,215.19
465,4.493465,223,102046,30.59,215.28
466,4.584790,218,102264,30.59,215.37
467,4.554123,219,102483,30.60,215.80
468,4.710629,212,102695,30.62,216.07
469,4.685064,214,102909,30.61,216.07
470,4.575156,218,103127,30.62,216.42
471,5.040749,198,103325,30.63,216.77
472,4.857019,206,103531,30.64,216.86
473,4.989235,200,103731,30.64,217.04
474,4.815996,208,103939,30.65,217.04
475,4.832830,206,104145,30.66,217.13
476,4.862926,206,104351,30.67,217.39
477,4.810322,208,104559,30.69,217.74
478,5.096836,196,104755,30.69,217.74
479,4.786404,209,104964,30.71,218.09
480,4.861733,206,105170,30.71,218.09
481,4.661474,214,105384,30.73,218.53
482,4.550505,220,105604,30.74,218.71
483,4.628915,216,105820,30.73,218.80
484,4.631490,210,106030,30.74,218.97
485,4.805911,213,106243,30.74,219.68
486,4.582427,218,106461,30.74,219.86
487,4.792830,209,106670,30.80,221.45
488,4.838521,206,106876,30.81,230.86
489,4.806116,208,107084,30.82,232.27
490,4.776085,209,107293,30.84,232.80
491,4.695035,213,107506,30.84,232.89
492,4.644842,215,107721,30.85,232.89
493,4.821759,207,107928,30.85,233.06
494,5.006206,200,108128,30.88,233.59
495,4.788410,209,108337,30.89,233.68
496,4.675419,213,108550,30.89,233.68
497,4.759024,211,108761,30.90,233.77
498,5.103561,195,108956,30.91,233.85
499,6.061260,165,109121,30.93,234.21
500,6.138285,163,109284,30.94,234.21
501,6.279575,159,109443,30.95,234.21
502,6.500104,154,109597,30.94,234.38
503,6.075250,165,109762,30.96,234.56
504,6.141944,162,109924,30.97,234.64
505,6.463802,155,110079,30.99,234.82
506,6.764019,148,110227,30.99,234.82
507,6.520585,153,110380,30.99,234.82
508,5.724438,174,110554,31.01,234.91
509,4.711845,213,110767,31.02,235.00
510,4.633433,216,110983,31.03,235.17
511,4.620478,216,111199,31.05,235.70
512,4.593835,218,111417,31.05,235.79
513,4.475910,223,111640,31.05,235.97
514,4.438794,225,111865,31.05,235.97
515,4.478573,223,112088,31.08,236.50
516,4.520161,221,112309,31.09,236.67
517,4.548450,218,112527,31.10,236.67
518,4.621860,219,112746,31.11,236.76
519,4.761415,209,112955,31.12,236.85
520,4.643054,216,113171,31.13,237.29
521,4.601619,217,113388,31.14,237.38
522,4.697738,213,113601,31.15,237.38
523,4.716042,212,113813,31.16,237.56
524,4.796971,208,114021,31.16,237.91
525,4.716117,212,114233,31.17,238.00
526,4.652245,215,114448,31.17,238.18
527,4.854525,205,114653,31.18,238.18
528,4.715893,212,114865,31.19,238.18
529,4.764707,210,115075,31.21,238.71
530,4.651459,215,115290,31.21,238.71
531,4.647469,215,115505,31.21,238.80
532,4.552900,219,115724,31.22,238.97
533,4.701860,213,115937,31.23,239.15
534,4.922488,203,116140,31.24,239.32
535,4.738772,211,116351,31.26,239.41
536,4.715159,212,116563,31.26,239.50
537,4.886716,205,116768,31.28,239.76
538,4.747672,210,116978,31.30,239.85
539,4.731216,211,117189,31.32,240.29
540,4.727839,212,117401,31.31,240.39
541,4.521812,221,117622,31.33,240.47
542,4.525429,221,117843,31.34,240.56
543,4.657782,214,118057,31.35,240.56
544,4.570528,219,118276,31.37,241.35
545,4.505043,222,118498,31.37,241.44
546,4.409572,227,118725,31.37,241.44
547,4.473742,223,118948,31.37,241.62
548,4.588998,218,119166,31.38,241.70
549,4.440773,225,119391,31.40,241.97
550,4.380477,228,119619,31.40,242.14
551,4.281210,233,119852,31.40,242.14
552,4.419909,227,120079,31.41,242.23
553,4.690094,213,120292,31.43,242.58
554,4.602014,217,120509,31.42,242.58
555,4.480862,223,120732,31.43,242.58
556,4.470110,224,120956,31.44,242.85
557,4.626355,216,121172,31.43,242.94
558,4.787656,208,121380,31.45,243.37
559,6.254246,160,121540,31.46,243.46
560,5.695274,175,121715,31.45,243.64
561,6.010093,167,121882,31.52,246.27
562,6.345053,158,122040,31.53,259.91
563,6.035485,165,122205,31.55,264.75
564,6.040571,166,122371,31.56,264.84
565,5.734437,174,122545,31.57,264.84
566,6.293791,159,122704,31.59,265.10
567,6.207712,161,122865,31.60,265.10
568,5.457919,183,123048,31.63,265.10
569,4.459236,224,123272,31.64,265.10
570,4.845708,207,123479,31.65,265.10
571,4.676717,213,123692,31.66,265.45
572,4.582083,218,123910,31.68,265.45
573,4.649702,215,124125,31.69,265.45
574,4.512276,222,124347,31.70,265.45
575,4.619438,216,124563,31.71,265.45
576,4.503046,222,124785,31.72,265.45
577,4.905874,204,124989,31.72,265.45
578,5.067367,197,125186,31.73,265.45
579,4.576477,219,125405,31.75,265.45
580,4.670664,214,125619,31.77,265.45
581,4.809921,207,125826,31.78,265.45
582,4.495111,223,126049,31.78,265.45
583,4.983471,201,126250,31.80,265.45
584,4.651070,214,126464,31.80,265.45
585,4.666712,215,126679,31.82,265.45
586,4.602459,217,126896,31.84,265.45
587,4.528490,221,127117,31.84,265.45
588,4.664197,214,127331,31.86,265.45
589,4.404188,227,127558,31.87,265.45
590,4.452819,224,127782,31.88,265.45
591,4.539936,220,128002,31.88,265.45
592,4.678729,214,128216,31.89,265.45
593,4.947425,202,128418,31.91,265.45
594,4.636383,216,128634,31.92,265.45
595,4.806406,208,128842,31.94,265.45
596,4.765113,209,129051,31.95,265.45
597,4.878196,205,129256,31.97,265.45
598,4.741012,211,129467,31.97,265.45
599,4.838376,207,129674,31.98,265.45
600,4.637819,215,129889,32.00,265.45
601,4.735287,211,130100,32.01,265.45
602,4.267108,234,130334,32.02,265.45
603,4.567025,219,130553,32.04,265.45
604,4.395696,227,130780,32.04,265.45
605,4.884262,205,130985,32.11,265.72
606,4.959577,202,131187,32.11,272.49
607,4.992840,200,131387,32.11,272.58
608,4.903830,204,131591,32.12,272.67
609,4.783545,209,131800,32.14,272.67
610,4.824986,207,132007,32.14,272.67
611,4.771318,208,132215,32.15,272.67
612,4.924283,204,132419,32.16,272.67
613,5.036510,199,132618,32.17,272.67
614,4.782687,209,132827,32.17,272.67
615,4.845927,206,133033,32.19,272.67
616,4.852611,206,133239,32.19,272.67
617,4.913538,203,133442,32.20,272.67
618,5.312437,189,133631,32.21,272.67
619,5.913200,168,133799,32.21,272.67
620,6.156344,163,133962,32.23,272.67
621,5.979506,167,134129,32.23,272.67
622,5.870253,170,134299,32.24,272.67
623,5.769589,173,134472,32.25,272.67
624,5.940663,169,134641,32.26,272.67
625,6.178766,161,134802,32.28,272.67
626,6.673626,150,134952,32.28,272.67
627,6.076611,165,135117,32.28,272.67
628,5.579468,179,135296,32.31,272.67
629,4.714159,212,135508,32.30,272.67
630,4.748017,210,135718,32.32,273.10
631,4.897854,204,135922,32.32,273.10
632,4.922147,203,136125,32.33,273.10
633,4.629214,216,136341,32.32,273.44
634,4.732883,211,136552,32.33,273.44
635,4.770939,210,136762,32.34,273.44
636,4.792552,208,136970,32.35,273.44
637,4.870537,205,137175,32.35,273.44
638,5.424482,185,137360,32.36,273.44
639,4.647796,215,137575,32.36,273.44
640,4.854676,206,137781,32.35,273.44
641,4.809887,207,137988,32.37,273.62
642,4.718579,212,138200,32.38,273.62
643,4.851371,206,138406,32.39,273.71
644,4.614596,217,138623,32.40,273.71
645,4.468076,224,138847,32.40,273.71
646,4.693957,213,139060,32.41,273.97
647,5.030993,198,139258,32.40,273.97
648,4.965677,202,139460,32.42,274.06
649,4.690987,213,139673,32.43,274.06
650,4.609524,217,139890,32.43,274.06
651,4.641956,215,140105,32.44,274.32
652,4.897606,204,140309,32.44,274.32
653,5.032550,198,140507,32.45,274.40
654,4.940158,203,140710,32.47,274.40
655,4.622376,216,140926,32.50,274.40
656,4.805431,208,141134,32.53,277.72
657,5.019918,199,141333,32.55,283.00
658,4.986752,201,141534,32.58,287.84
659,4.731425,211,141745,32.60,288.28
660,4.926777,203,141948,32.59,288.28
661,4.877326,205,142153,32.62,288.28
662,4.931121,202,142355,32.63,288.28
663,4.816054,208,142563,32.65,288.28
664,5.004256,200,142763,32.66,288.28
665,4.931367,202,142965,32.66,288.28
666,4.833561,207,143172,32.67,288.28
667,4.899104,204,143376,32.68,288.28
668,4.835117,207,143583,32.69,288.28
669,4.793744,208,143791,32.70,288.28
670,4.658067,215,144006,32.70,288.63
671,4.704763,212,144218,32.71,288.63
672,4.866581,206,144424,32.73,288.63
673,4.859319,206,144630,32.73,288.63
674,4.844378,206,144836,32.73,288.63
675,4.848213,206,145042,32.74,288.63
676,4.764033,210,145252,32.76,288.63
677,4.904533,204,145456,32.77,288.63
678,5.447792,183,145639,32.76,288.63
679,6.529731,153,145792,32.78,288.63
680,6.497702,154,145946,32.77,288.63
681,6.169395,162,146108,32.78,288.63
682,6.310364,159,146267,32.79,288.63
683,5.948952,167,146434,32.81,288.63
684,6.350900,158,146592,32.81,288.63
685,6.056946,165,146757,32.83,288.63
686,7.097967,141,146898,32.81,288.63
687,6.362141,157,147055,32.84,288.63
688,5.740502,174,147229,32.83,288.63
689,4.754698,210,147439,32.85,288.63
690,4.604878,218,147657,32.85,288.63
691,4.715497,211,147868,32.86,288.63
692,4.641323,216,148084,32.87,288.63
693,4.447700,224,148308,32.89,288.63
694,4.686049,214,148522,32.88,288.63
695,4.536964,218,148740,32.89,288.63
696,4.506603,224,148964,32.91,288.63
697,4.720175,212,149176,32.91,288.63
698,4.504184,222,149398,32.91,288.63
699,4.854278,206,149604,32.91,288.63
700,4.688080,213,149817,32.93,288.63
701,4.676461,214,150031,32.94,288.63
702,4.659513,214,150245,32.94,288.63
703,4.705494,213,150458,32.94,288.63
704,4.581254,218,150676,32.95,288.63
705,4.704208,212,150888,32.95,288.63
706,4.424178,226,151114,32.97,288.63
707,4.631310,216,151330,32.96,288.63
708,4.601751,217,151547,32.97,288.63
709,4.507630,222,151769,32.98,288.63
710,4.736740,210,151979,32.99,288.63
711,4.696948,213,152192,32.99,288.63
712,4.697661,213,152405,33.00,288.63
713,4.794163,209,152614,33.00,288.63
714,4.610273,216,152830,33.02,288.63
715,4.543591,220,153050,33.03,288.63
716,4.530470,221,153271,33.04,288.63
717,4.673321,214,153485,33.04,288.63
718,4.565472,218,153703,33.06,288.63
719,4.616576,217,153920,33.06,288.63
720,4.574623,219,154139,33.08,288.63
721,4.544249,220,154359,33.11,288.63
722,4.544981,220,154579,33.09,288.63
723,4.483211,222,154801,33.11,288.63
724,4.650994,215,155016,33.10,288.63
725,4.401808,227,155243,33.11,288.63
726,4.548801,220,155463,33.12,288.63
727,4.472588,224,155687,33.11,288.63
728,4.504207,222,155909,33.13,288.63
729,4.515221,221,156130,33.12,288.63
730,4.417037,226,156356,33.14,288.63
731,4.482212,223,156579,33.14,288.63
732,4.404459,227,156806,33.14,288.63
733,4.525286,221,157027,33.14,288.63
734,4.963911,201,157228,33.17,288.74
735,4.865927,206,157434,33.20,289.64
736,4.833274,207,157641,33.20,295.62
737,4.950265,202,157843,33.22,295.71
738,5.365148,186,158029,33.26,296.07
739,6.250961,160,158189,33.25,297.83
740,6.043066,165,158354,33.27,302.84
741,6.168001,162,158516,33.28,302.84
742,6.189952,162,158678,33.28,302.84
743,5.882996,170,158848,33.30,302.84
744,5.988821,166,159014,33.30,302.84
745,5.920039,169,159183,33.30,302.84
746,6.440778,155,159338,33.33,302.84
747,6.772285,148,159486,33.32,302.84
748,5.765665,173,159659,33.34,302.84
749,5.064657,198,159857,33.35,302.84
750,5.159618,193,160050,33.35,302.84
751,5.036980,199,160249,33.35,302.84
752,5.118431,195,160444,33.36,302.84
753,5.137418,194,160638,33.37,302.84
754,5.098195,197,160835,33.38,302.84
755,4.797181,208,161043,33.38,302.84
756,4.857629,205,161248,33.39,302.84
757,4.913861,204,161452,33.40,302.84
758,5.025775,199,161651,33.39,302.84
759,4.938617,202,161853,33.41,302.84
760,5.136245,195,162048,33.42,302.84
761,4.955268,202,162250,33.43,302.84
762,4.610124,217,162467,33.43,302.84
763,5.597848,178,162645,33.44,302.84
764,4.756472,210,162855,33.44,302.84
765,4.680213,214,163069,33.45,303.19
766,4.789099,209,163278,33.46,303.72
767,4.800517,208,163486,33.46,303.72
768,4.917008,203,163689,33.47,303.72
769,4.709056,212,163901,33.48,303.72
770,4.848691,207,164108,33.49,303.72
771,5.005149,199,164307,33.49,303.72
772,4.981978,201,164508,33.49,303.72
773,5.069729,197,164705,33.50,303.72
774,5.186144,193,164898,33.51,303.72
775,4.916378,203,165101,33.52,303.72
776,5.285751,189,165290,33.53,303.72
777,5.234676,191,165481,33.53,303.72
778,4.934508,203,165684,33.55,303.72
779,5.042789,198,165882,33.55,303.72
780,5.087720,197,166079,33.57,303.72
781,4.834883,206,166285,33.58,303.72
782,4.808942,208,166493,33.57,303.72
783,4.711276,212,166705,33.59,303.72
784,4.582214,219,166924,33.59,303.72
785,4.702710,212,167136,33.59,303.72
786,4.683456,214,167350,33.60,303.72
787,4.690529,213,167563,33.61,303.72
788,4.797349,208,167771,33.61,303.72
789,4.755755,210,167981,33.66,303.80
790,4.993406,200,168181,33.68,306.35
791,4.983802,201,168382,33.68,306.88
792,4.881019,205,168587,33.68,312.27
793,5.383628,185,168772,33.71,312.97
794,5.158009,194,168966,33.69,313.06
795,4.785533,209,169175,33.71,313.06
796,5.026968,199,169374,33.71,313.06
797,5.061806,197,169571,33.72,313.50
798,5.501836,182,169753,33.73,313.50
799,6.201019,161,169914,33.72,313.50
800,6.473051,155,170069,33.75,313.50
801,6.157149,162,170231,33.73,313.50
802,6.492702,154,170385,33.75,313.50
803,6.413081,156,170541,33.75,313.50
804,6.521886,153,170694,33.76,313.50
805,6.335820,158,170852,33.76,313.58
806,6.192701,160,171012,33.78,313.58
807,6.611855,152,171164,33.78,313.58
808,5.668757,177,171341,33.78,313.58
809,5.103501,196,171537,33.79,313.58
810,4.974985,201,171738,33.80,313.84
811,4.623995,216,171954,33.81,313.84
812,4.749617,210,172164,33.81,313.84
813,4.707523,213,172377,33.81,313.84
814,4.864519,205,172582,33.83,313.84
815,4.877985,205,172787,33.83,313.84
816,5.029445,199,172986,33.84,313.84
817,4.892317,204,173190,33.84,313.84
818,4.705502,213,173403,33.84,313.84
819,5.070353,197,173600,33.85,313.84
820,4.794050,208,173808,33.85,313.84
821,4.746324,211,174019,33.87,313.84
822,4.659892,214,174233,33.86,313.84
823,5.004728,200,174433,33.87,313.84
824,4.923942,203,174636,33.88,313.84
825,4.802333,208,174844,33.88,313.84
826,4.721787,212,175056,33.88,313.84
827,4.846872,206,175262,33.88,313.84
828,4.769040,209,175471,33.89,313.84
829,4.612959,217,175688,33.90,313.84
830,4.959687,202,175890,33.90,313.84
831,4.835164,207,176097,33.92,313.84
832,4.878699,205,176302,33.90,313.84
833,4.686790,213,176515,33.93,313.93
834,4.948082,202,176717,33.93,314.20
835,4.725874,211,176928,33.94,314.20
836,4.944969,202,177130,33.95,314.20
837,4.687816,214,177344,33.96,314.28
838,4.947542,202,177546,33.96,314.55
839,4.522111,221,177767,33.97,314.72
840,4.758230,210,177977,33.98,314.99
841,4.545197,220,178197,33.99,315.08
842,4.867484,205,178402,33.99,315.34
843,4.877602,205,178607,34.01,315.34
844,4.900340,204,178811,34.00,315.34
845,4.569362,219,179030,34.02,315.34
846,4.731780,211,179241,34.00,315.34
847,4.491174,223,179464,34.03,315.34
848,4.839624,206,179670,34.01,315.34
849,4.482026,223,179893,34.04,315.43
850,4.632925,216,180109,34.02,315.60
851,4.526948,221,180330,34.04,315.60
852,4.528579,220,180550,34.04,315.60
853,4.884446,205,180755,34.05,315.60
854,4.626377,216,180971,34.05,315.60
855,4.803929,208,181179,34.06,316.04
856,4.563009,219,181398,34.05,316.04
857,4.764660,210,181608,34.06,316.31
858,4.935624,202,181810,34.06,316.31
859,6.012107,167,181977,34.06,316.31
860,5.754818,173,182150,34.06,316.31
861,5.679694,176,182326,34.06,316.31
862,5.829833,172,182498,34.07,316.66
863,5.648870,177,182675,34.08,316.66
864,5.667395,176,182851,34.07,316.66
865,5.980555,167,183018,34.08,316.66
866,5.761620,174,183192,34.08,316.66
867,6.039651,165,183357,34.08,316.66
868,5.352132,187,183544,34.11,316.92
869,5.147015,194,183738,34.13,318.77
870,4.979857,201,183939,34.15,327.04
871,4.892652,204,184143,34.14,327.13
872,5.030311,199,184342,34.15,327.65
873,5.015696,199,184541,34.16,327.74
874,4.988315,201,184742,34.14,327.74
875,5.017216,199,184941,34.16,327.74
876,5.158913,194,185135,34.15,327.74
877,4.806166,208,185343,34.17,327.74
878,5.094947,196,185539,34.16,327.74
879,5.186131,193,185732,34.15,327.74
880,4.750001,210,185942,34.17,327.74
881,4.976991,201,186143,34.17,327.74
882,4.991389,200,186343,34.16,327.74
883,4.681366,214,186557,34.17,327.74
884,4.860003,206,186763,34.18,327.74
885,4.913037,203,186966,34.18,327.74
886,4.668501,214,187180,34.17,327.74
887,5.146751,194,187374,34.18,327.74
888,4.989806,201,187575,34.18,327.74
889,4.736881,211,187786,34.19,327.74
890,4.799952,208,187994,34.19,327.74
891,4.917331,203,188197,34.19,327.74
892,5.101473,196,188393,34.19,327.74
893,4.975170,201,188594,34.19,327.74
894,4.778917,209,188803,34.21,327.74
895,4.964365,201,189004,34.21,327.74
896,4.864557,206,189210,34.21,327.74
897,4.608379,217,189427,34.22,327.74
898,4.923953,199,189626,34.23,327.74
899,5.555833,183,189809,34.23,327.74
900,4.945196,202,190011,34.24,327.74
901,4.830462,207,190218,34.23,327.74
902,4.757248,211,190429,34.25,327.74
903,4.999539,199,190628,34.24,327.74
904,4.730391,212,190840,34.23,327.74
905,4.839398,206,191046,34.25,327.74
906,4.803358,208,191254,34.24,327.74
907,4.544078,220,191474,34.25,327.74
908,5.156450,194,191668,34.26,327.83
909,4.623001,216,191884,34.25,327.83
910,4.741832,211,192095,34.25,327.83
911,4.812704,208,192303,34.25,327.83
912,4.459044,224,192527,34.25,327.83
913,4.976207,201,192728,34.26,327.83
914,4.647542,215,192943,34.29,328.01
915,4.899166,204,193147,34.31,328.01
916,4.829780,207,193354,34.30,328.01
917,5.011662,199,193553,34.32,336.35
918,4.993947,200,193753,34.31,336.62
919,6.544069,153,193906,34.32,336.88
920,6.185758,162,194068,34.31,337.06
921,6.460077,154,194222,34.34,337.14
922,6.105393,164,194386,34.33,337.14
923,6.362536,157,194543,34.32,337.14
924,6.263507,159,194702,34.32,337.14
925,6.469956,155,194857,34.32,337.14
926,7.220270,139,194996,34.34,337.32
927,6.660091,150,195146,34.33,337.32
928,6.249177,160,195306,34.33,337.32
929,4.686735,213,195519,34.33,337.41
930,4.688662,213,195732,34.36,337.93
931,4.501273,222,195954,34.35,337.93
932,4.834468,207,196161,34.35,338.37
933,4.676147,214,196375,34.35,338.37
934,4.675089,214,196589,34.36,338.37
935,4.758903,210,196799,34.36,338.37
936,4.632168,215,197014,34.35,338.37
937,4.847440,207,197221,34.36,338.81
938,4.606480,216,197437,34.37,338.81
939,4.879633,205,197642,34.36,338.81
940,4.515619,222,197864,34.37,339.16
941,4.799421,208,198072,34.37,339.42
942,4.499885,222,198294,34.39,339.51
943,4.842917,206,198500,34.39,339.51
944,4.527253,221,198721,34.38,339.51
945,4.785649,209,198930,34.38,339.51
946,4.565605,219,199149,34.39,340.39
947,4.929305,203,199352,34.39,340.39
948,4.940588,202,199554,34.39,340.39
949,5.067922,197,199751,34.43,340.82
950,4.967669,201,199952,34.45,343.54
951,5.372065,186,200138,34.44,347.68
952,5.297236,189,200327,34.46,358.15
953,5.353186,187,200514,34.45,358.33
954,5.827883,171,200685,34.48,358.33
955,5.241059,191,200876,34.48,358.33
956,5.384829,185,201061,34.49,358.33
957,5.085175,197,201258,34.49,358.33
958,5.427062,184,201442,34.49,358.33
959,5.112260,195,201637,34.50,358.33
960,5.144471,195,201832,34.51,358.33
961,5.152744,194,202026,34.52,358.33
962,4.855828,206,202232,34.53,358.33
963,5.121625,194,202426,34.53,358.33
964,4.947594,203,202629,34.54,358.33
965,5.103677,196,202825,34.54,358.42
966,4.834857,206,203031,34.54,358.42
967,4.964812,202,203233,34.54,358.42
968,4.970520,201,203434,34.54,358.42
969,4.691420,213,203647,34.55,358.42
970,5.263106,190,203837,34.55,358.42
971,4.707128,212,204049,34.56,358.42
972,4.886703,204,204253,34.57,358.42
973,4.948474,202,204455,34.57,358.42
974,4.796971,209,204664,34.57,358.42
975,5.006703,199,204863,34.58,358.42
976,4.877588,205,205068,34.58,358.42
977,5.019770,199,205267,34.60,358.42
978,5.232216,191,205458,34.59,358.42
979,6.191844,161,205619,34.59,358.42
980,6.574950,153,205772,34.61,358.42
981,6.311575,158,205930,34.60,358.42
982,6.063854,165,206095,34.60,358.42
983,6.178713,162,206257,34.61,358.42
984,5.835196,171,206428,34.61,358.42
985,5.879578,170,206598,34.61,358.42
986,6.373930,157,206755,34.63,358.42
987,6.484272,154,206909,34.63,358.42
988,5.453833,183,207092,34.63,358.42
989,4.905131,204,207296,34.64,358.42
990,4.656323,215,207511,34.64,358.42
991,4.705194,212,207723,34.64,358.42
992,4.888864,205,207928,34.65,358.42
993,4.585782,218,208146,34.65,358.42
994,4.747294,210,208356,34.66,358.42
995,4.520762,221,208577,34.66,358.42
996,4.501785,223,208800,34.65,358.42
997,4.846262,206,209006,34.66,358.42
998,4.596734,217,209223,34.67,358.42
999,4.917397,204,209427,34.67,358.42
1000,4.548599,219,209646,34.67,358.42
1001,4.521404,221,209867,34.68,358.42
1002,4.709557,213,210080,34.69,358.42
1003,4.594151,217,210297,34.68,358.42
1004,4.464354,224,210521,34.68,358.42
1005,4.852697,206,210727,34.69,358.59
1006,4.410068,227,210954,34.70,358.59
1007,4.692837,213,211167,34.70,358.77
1008,4.510076,221,211388,34.70,358.77
1009,4.539641,220,211608,34.69,358.77
1010,4.593071,218,211826,34.71,358.85
1011,4.491155,223,212049,34.70,358.94
1012,4.663597,214,212263,34.71,358.94
1013,4.847077,206,212469,34.72,359.20
1014,4.684237,214,212683,34.72,359.20
1015,4.629986,215,212898,34.72,359.20
1016,4.975407,201,213099,34.74,359.47
1017,4.677898,214,213313,34.73,359.47
1018,4.910232,204,213517,34.74,359.47
1019,4.909116,203,213720,34.75,359.90
1020,4.676911,214,213934,34.75,359.90
1021,4.561926,219,214153,34.76,359.90
1022,4.783003,209,214362,34.76,359.99
1023,4.468636,224,214586,34.75,359.99
1024,4.549624,219,214805,34.76,359.99
1025,4.757144,210,215015,34.76,360.08
1026,4.571424,219,215234,34.78,360.08
1027,4.516700,221,215455,34.77,360.08
1028,4.858135,206,215661,34.78,360.52
1029,4.561311,219,215880,34.78,360.52
1030,4.679443,214,216094,34.78,360.52
1031,4.797611,208,216302,34.78,360.78
1032,4.574657,219,216521,34.78,360.78
1033,4.619529,216,216737,34.77,360.78
1034,4.485894,213,216950,34.78,360.96
1035,5.091728,205,217155,34.79,361.05
1036,4.552582,219,217374,34.78,361.05
1037,4.722453,212,217586,34.78,361.05
1038,5.561846,180,217766,34.79,361.13
1039,6.180380,161,217927,34.80,361.13
1040,5.673648,177,218104,34.79,361.13
1041,5.931991,168,218272,34.78,361.13
1042,5.898959,170,218442,34.80,361.13
1043,6.154418,162,218604,34.79,361.13
1044,6.136782,163,218767,34.79,361.48
1045,6.131857,162,218929,34.80,361.48
1046,6.300282,159,219088,34.79,361.48
1047,5.972307,167,219255,34.79,361.48
1048,6.056066,166,219421,34.81,361.65
1049,4.487620,223,219644,34.81,361.74
1050,4.439621,225,219869,34.82,361.74
1051,4.645972,215,220084,34.81,361.74
1052,4.369585,229,220313,34.81,362.00
1053,4.285315,232,220545,34.81,362.00
1054,4.615042,217,220762,34.81,362.00
1055,5.384179,186,220948,34.85,363.41
1056,4.916964,203,221151,34.86,367.50
1057,5.344082,187,221338,34.86,371.20
1058,4.918354,203,221541,34.87,381.32
1059,5.018135,199,221740,34.86,381.67
1060,4.843380,207,221947,34.87,382.02
1061,5.085581,197,222144,34.87,382.02
1062,4.731662,211,222355,34.87,382.02
1063,5.007713,199,222554,34.87,382.02
1064,4.920690,204,222758,34.87,382.02
1065,4.791339,208,222966,34.88,382.37
1066,5.217927,192,223158,34.88,382.37
1067,4.615791,216,223374,34.88,382.37
1068,4.973254,201,223575,34.86,382.37
1069,4.698782,213,223788,34.88,382.54
1070,4.777138,209,223997,34.87,382.54
1071,4.717430,212,224209,34.87,382.54
1072,5.094922,196,224405,34.88,382.54
1073,5.054754,198,224603,34.89,382.81
1074,4.761878,210,224813,34.89,382.81
1075,5.189210,193,225006,34.89,382.81
1076,4.951059,201,225207,34.89,382.81
1077,5.127673,195,225402,34.89,382.81
1078,4.872998,206,225608,34.91,383.24
1079,5.110717,195,225803,34.90,383.24
1080,4.823776,207,226010,34.92,383.24
1081,5.130139,195,226205,34.91,383.24
1082,4.627232,216,226421,34.92,384.03
1083,4.843584,207,226628,34.92,384.03
1084,5.882049,170,226798,34.92,384.03
1085,4.953600,201,226999,34.90,384.03
1086,4.661266,215,227214,34.91,384.03
1087,4.988834,200,227414,34.91,384.12
1088,4.772319,210,227624,34.95,384.35
1089,5.068341,197,227821,34.95,384.35
1090,4.604931,217,228038,34.96,384.35
1091,4.827698,207,228245,34.96,392.08
1092,4.511144,221,228466,34.97,392.35
1093,4.943824,203,228669,34.97,392.35
1094,4.505963,221,228890,34.98,392.61
1095,4.888718,205,229095,34.98,392.61
1096,4.693661,212,229307,34.98,392.61
1097,4.921015,204,229511,34.98,392.61
1098,4.906428,203,229714,34.99,392.61
1099,6.139962,163,229877,34.99,392.78
1100,5.727279,175,230052,35.01,392.78
1101,5.788613,173,230225,35.00,392.78
1102,6.123213,163,230388,35.00,392.78
1103,5.593481,179,230567,35.00,392.78
1104,6.176325,161,230728,35.00,392.78
1105,5.772456,173,230901,35.01,392.87
1106,5.939530,169,231070,35.02,393.40
1107,6.302473,158,231228,35.02,393.40
1108,5.126046,196,231424,35.03,393.40
1109,4.620163,216,231640,35.03,393.40
1110,4.340413,230,231870,35.03,393.40
1111,4.758005,210,232080,35.03,393.40
1112,4.476830,224,232304,35.04,394.19
1113,4.837496,206,232510,35.04,394.19
1114,5.010570,200,232710,35.07,394.54
1115,4.800416,208,232918,35.09,399.55
1116,5.433298,184,233102,35.10,418.38
1117,4.930981,203,233305,35.10,418.38
1118,5.220972,191,233496,35.09,419.08
1119,5.013226,199,233695,35.11,419.26
1120,5.315324,188,233883,35.10,419.35
1121,4.976089,201,234084,35.12,419.35
1122,5.021276,199,234283,35.11,419.35
1123,5.313127,188,234471,35.13,419.35
1124,4.881455,205,234676,35.12,419.35
1125,5.118442,195,234871,35.13,419.35
1126,4.925096,203,235074,35.13,419.35
1127,4.879155,205,235279,35.14,419.35
1128,5.210473,192,235471,35.14,419.35
1129,4.883822,205,235676,35.15,419.35
1130,5.172125,193,235869,35.14,419.35
1131,4.877375,205,236074,35.15,419.35
1132,4.931678,201,236275,35.16,419.35
1133,5.243782,192,236467,35.17,419.35
1134,4.981311,201,236668,35.17,419.35
1135,5.200333,192,236860,35.17,419.35
1136,4.725012,212,237072,35.19,419.35
1137,5.254746,190,237262,35.19,419.35
1138,4.855174,206,237468,35.21,419.35
1139,4.880829,205,237673,35.20,419.35
1140,5.083952,196,237869,35.22,419.35
1141,4.746046,211,238080,35.22,419.35
1142,4.699126,213,238293,35.23,419.35
1143,5.092937,196,238489,35.24,419.35
1144,4.787372,209,238698,35.24,419.35
1145,4.963418,201,238899,35.24,419.35
1146,4.889058,205,239104,35.25,419.35
1147,4.739750,210,239314,35.25,419.35
1148,5.122148,195,239509,35.24,419.35
1149,4.709589,213,239722,35.25,419.35
1150,5.042580,198,239920,35.25,419.35
1151,4.722873,212,240132,35.26,419.35
1152,4.852492,206,240338,35.26,419.35
1153,5.057245,197,240535,35.26,419.35
1154,4.964185,202,240737,35.27,419.35
1155,5.114977,195,240932,35.26,419.35
1156,5.242682,191,241123,35.26,419.35
1157,4.719064,212,241335,35.27,419.35
1158,5.154197,193,241528,35.27,419.35
1159,6.280668,159,241687,35.28,419.35
1160,5.787617,173,241860,35.27,419.35
1161,5.870299,171,242031,35.28,419.35
1162,6.258880,159,242190,35.28,419.35
1163,6.004172,167,242357,35.30,419.35
1164,5.837418,171,242528,35.29,419.35
1165,5.681663,176,242704,35.29,419.35
1166,6.313785,158,242862,35.30,419.35
1167,6.134574,163,243025,35.30,419.35
1168,5.637133,178,243203,35.30,419.35
1169,4.937154,202,243405,35.30,419.35
1170,4.769930,210,243615,35.30,419.35
1171,4.635147,215,243830,35.30,419.35
1172,4.896003,204,244034,35.31,419.35
1173,4.701102,213,244247,35.31,419.35
1174,4.718051,212,244459,35.32,419.35
1175,4.808449,207,244666,35.31,419.35
1176,4.638954,216,244882,35.32,419.35
1177,4.581001,218,245100,35.32,419.35
1178,4.753006,210,245310,35.33,419.35
1179,4.681873,214,245524,35.33,419.35
1180,4.682032,213,245737,35.32,419.35
1181,4.869934,205,245942,35.33,419.35
1182,4.444249,225,246167,35.33,419.35
1183,4.556750,220,246387,35.32,419.35
1184,4.787596,208,246595,35.34,419.35
1185,4.775952,210,246805,35.33,419.35
1186,4.538521,220,247025,35.33,419.35
1187,4.691014,213,247238,35.34,419.35
1188,4.508291,222,247460,35.33,419.35
1189,4.570751,218,247678,35.33,419.35
1190,4.757088,210,247888,35.33,419.35
1191,4.523811,221,248109,35.33,419.35
1192,4.590347,218,248327,35.35,419.35
1193,4.733473,211,248538,35.34,419.35
1194,4.592240,218,248756,35.36,419.35
1195,4.504069,222,248978,35.36,419.35
1196,4.707966,212,249190,35.35,419.35
1197,4.589286,218,249408,35.37,419.35
1198,4.507690,222,249630,35.37,419.35
1199,4.775200,209,249839,35.37,419.35
1200,4.490221,223,250062,35.39,419.35
1201,4.399367,227,250289,35.39,419.35
1202,4.539953,220,250509,35.38,419.35
1203,4.729710,211,250720,35.40,419.35
1204,4.468919,224,250944,35.39,419.35
1205,4.570058,219,251163,35.38,419.35
1206,4.547654,212,251375,35.39,419.35
1207,4.689141,220,251595,35.39,419.35
1208,4.624759,217,251812,35.38,419.35
1209,4.322411,231,252043,35.39,419.35
1210,4.730076,211,252254,35.38,419.35
1211,4.447881,225,252479,35.38,419.35
1212,4.391626,228,252707,35.39,419.35
1213,4.539115,220,252927,35.38,419.35
1214,4.711359,212,253139,35.38,419.35
1215,4.363699,229,253368,35.39,419.35
1216,4.325797,231,253599,35.38,419.35
1217,4.754487,210,253809,35.39,419.35
1218,5.169159,194,254003,35.39,419.35
1219,5.648665,177,254180,35.39,419.35
1220,5.394642,185,254365,35.38,419.35
1221,5.798462,172,254537,35.38,419.35
1222,5.631532,178,254715,35.40,419.35
1223,5.337721,187,254902,35.39,419.35
1224,5.413488,185,255087,35.38,419.35
1225,5.438054,184,255271,35.39,419.35
1226,5.792848,172,255443,35.39,419.35
1227,6.384635,157,255600,35.40,419.35
1228,5.120391,195,255795,35.39,419.35
1229,4.380789,228,256023,35.39,419.35
1230,4.262442,235,256258,35.39,419.35
1231,4.400209,227,256485,35.39,419.35
1232,4.229246,236,256721,35.39,419.35
1233,4.238992,236,256957,35.39,419.35
1234,4.245550,235,257192,35.39,419.35
1235,4.476686,224,257416,35.39,419.35
1236,4.213676,237,257653,35.40,419.35
1237,4.151975,240,257893,35.39,419.35
1238,4.093710,245,258138,35.39,419.35
1239,4.433130,225,258363,35.38,419.43
1240,4.211157,237,258600,35.40,419.43
1241,4.302337,233,258833,35.43,419.43
1242,4.362544,229,259062,35.43,419.43
1243,4.304659,232,259294,35.44,419.52
1244,4.470636,224,259518,35.44,419.52
1245,4.315050,231,259749,35.45,424.62
1246,4.234592,236,259985,35.46,425.06
1247,4.408766,227,260212,35.50,425.41
1248,4.390833,228,260440,35.49,432.19
1249,4.549708,219,260659,35.51,434.04
1250,4.380143,228,260887,35.51,443.37
1251,4.460673,225,261112,35.51,443.63
1252,4.659985,214,261326,35.52,443.63
1253,4.474401,224,261550,35.52,443.72
1254,4.798744,208,261758,35.53,443.98
1255,4.515314,221,261979,35.53,443.98
1256,4.643407,215,262194,35.54,443.98
1257,4.686483,214,262408,35.54,443.98
1258,4.557147,219,262627,35.56,444.33
1259,4.605253,217,262844,35.55,444.33
1260,4.699564,213,263057,35.58,444.33
1261,4.467757,224,263281,35.57,444.33
1262,4.359590,229,263510,35.59,444.33
1263,4.556063,219,263729,35.58,444.33
1264,4.488626,223,263952,35.58,444.33
1265,4.356771,229,264181,35.58,444.33
1266,4.597030,218,264399,35.59,444.33
1267,4.441161,225,264624,35.59,444.33
1268,4.444396,225,264849,35.59,444.33
1269,4.481068,223,265072,35.60,444.33
1270,4.438080,225,265297,35.60,444.33
1271,4.594771,217,265514,35.59,444.33
1272,4.683023,214,265728,35.60,444.33
1273,4.482740,223,265951,35.61,444.33
1274,4.617942,206,266157,35.65,444.51
1275,6.048292,173,266330,35.66,449.87
1276,5.268537,190,266520,35.66,469.49
1277,5.651566,177,266697,35.67,479.26
1278,5.631409,177,266874,35.66,479.97
1279,7.096089,141,267015,35.66,480.58
1280,6.393489,156,267171,35.67,480.58
1281,6.439896,155,267326,35.67,480.58
1282,6.715653,149,267475,35.68,480.58
1283,6.269278,160,267635,35.69,480.58
1284,6.203119,161,267796,35.68,480.58
1285,6.612191,151,267947,35.69,480.58
1286,6.972270,143,268090,35.69,480.58
1287,7.331130,136,268226,35.70,480.67
1288,6.134679,164,268390,35.70,480.67
1289,5.130727,194,268584,35.70,480.67
1290,5.591268,179,268763,35.70,480.67
1291,5.371063,186,268949,35.71,480.67
1292,5.100190,196,269145,35.70,480.67
1293,5.511944,181,269326,35.71,480.67
1294,4.986950,201,269527,35.72,480.67
1295,5.402603,185,269712,35.71,480.67
1296,5.018372,199,269911,35.73,480.67
1297,5.373016,185,270096,35.72,480.67
1298,5.040103,199,270295,35.72,480.67
1299,5.266186,190,270485,35.73,480.67
1300,5.458393,183,270668,35.73,480.67
1301,5.015878,199,270867,35.73,480.67
1302,5.636185,177,271044,35.74,480.67
1303,5.297079,189,271233,35.74,480.67
1304,5.339274,178,271411,35.74,480.67
1305,6.640974,158,271569,35.73,480.67
1306,4.910479,203,271772,35.73,480.67
1307,5.074010,193,271965,35.73,480.67
1308,5.001825,204,272169,35.73,480.67
1309,4.828244,207,272376,35.74,480.67
1310,5.050241,198,272574,35.75,480.67
1311,4.906654,204,272778,35.74,480.67
1312,5.400840,185,272963,35.75,480.67
1313,4.889511,205,273168,35.76,480.67
1314,4.893361,204,273372,35.75,480.67
1315,5.285501,189,273561,35.77,480.67
1316,4.988882,200,273761,35.77,480.67
1317,5.206512,192,273953,35.77,480.67
1318,4.947665,202,274155,35.77,480.67
1319,4.826219,208,274363,35.78,480.67
1320,5.324068,187,274550,35.78,480.88
1321,4.777005,210,274760,35.79,480.88
1322,5.000896,200,274960,35.80,480.88
1323,4.688805,213,275173,35.80,480.88
1324,4.725583,211,275384,35.79,480.88
1325,5.034981,199,275583,35.80,480.88
1326,4.737908,211,275794,35.80,480.88
1327,5.121980,195,275989,35.80,480.88
1328,4.730162,211,276200,35.80,480.88
1329,4.748487,210,276410,35.80,480.88
1330,5.155862,194,276604,35.81,480.88
1331,4.804771,208,276812,35.80,480.88
1332,4.965858,202,277014,35.81,480.88
1333,4.747910,210,277224,35.81,480.88
1334,4.609078,217,277441,35.80,480.88
1335,4.907778,204,277645,35.82,480.88
1336,4.712177,212,277857,35.81,480.88
1337,5.052944,198,278055,35.81,480.88
1338,4.975414,200,278255,35.81,480.88
1339,5.832341,172,278427,35.81,480.88
1340,6.207565,161,278588,35.82,480.88
1341,5.705374,175,278763,35.82,480.88
1342,5.780308,173,278936,35.82,480.88
1343,5.937934,168,279104,35.82,480.88
1344,6.141763,163,279267,35.83,480.88
1345,5.721747,175,279442,35.82,480.88
1346,5.896593,169,279611,35.82,480.88
1347,6.445030,155,279766,35.83,480.88
1348,5.114272,196,279962,35.84,480.88
1349,4.540399,220,280182,35.83,480.88
1350,4.813807,208,280390,35.83,480.88
1351,4.511429,221,280611,35.84,480.88
1352,4.501218,222,280833,35.83,480.88
1353,4.920054,204,281037,35.83,480.88
1354,4.438673,225,281262,35.84,480.88
1355,4.884530,204,281466,35.85,480.88
1356,4.507210,222,281688,35.84,480.88
1357,4.474257,224,281912,35.84,480.88
1358,4.788959,208,282120,35.84,480.88
1359,4.409310,227,282347,35.84,480.88
1360,4.558596,219,282566,35.84,480.88
1361,4.856565,206,282772,35.84,480.88
1362,4.570862,219,282991,35.84,480.88
1363,5.027445,198,283189,35.85,480.88
1364,4.600492,218,283407,35.84,480.88
1365,4.488268,222,283629,35.83,480.88
1366,4.835698,207,283836,35.85,480.88
1367,4.502925,222,284058,35.85,480.88
1368,4.616329,216,284274,35.84,480.88
1369,4.977958,201,284475,35.84,480.88
1370,4.548236,220,284695,35.84,480.88
1371,4.623817,216,284911,35.84,480.88
1372,5.063635,197,285108,35.85,480.88
1373,4.855261,206,285314,35.84,480.88
1374,4.653058,215,285529,35.84,480.88
1375,4.638371,207,285736,35.85,480.88
1376,5.005468,207,285943,35.86,480.88
1377,4.648679,215,286158,35.86,480.88
1378,4.651245,215,286373,35.85,480.88
1379,4.894178,204,286577,35.86,480.88
1380,4.731682,211,286788,35.87,480.88
1381,4.596267,218,287006,35.86,480.88
1382,4.774835,209,287215,35.87,480.88
1383,4.537360,220,287435,35.86,480.88
1384,4.417317,226,287661,35.87,480.88
1385,4.665772,214,287875,35.87,480.88
1386,4.467624,224,288099,35.86,480.88
1387,4.460440,224,288323,35.85,480.88
1388,4.664886,214,288537,35.88,480.88
1389,4.368741,229,288766,35.90,480.96
1390,4.559052,219,288985,35.90,481.05
1391,5.002196,200,289185,35.91,484.13
1392,4.453942,225,289410,35.92,494.04
1393,4.586151,218,289628,35.91,494.59
1394,4.428228,225,289853,35.91,494.86
1395,4.712849,212,290065,35.92,494.86
1396,4.466456,224,290289,35.92,494.95
1397,4.484664,223,290512,35.92,494.95
1398,5.322334,188,290700,35.91,494.95
1399,5.961692,167,290867,35.92,494.95
1400,5.818974,172,291039,35.93,494.95
1401,6.537940,153,291192,35.92,494.95
1402,6.315473,158,291350,35.91,494.95
1403,5.978442,168,291518,35.93,494.95
1404,5.879629,170,291688,35.92,494.95
1405,5.825927,171,291859,35.93,494.95
1406,6.389314,157,292016,35.93,494.95
1407,6.933605,144,292160,35.92,494.95
1408,5.533784,181,292341,35.93,494.95
1409,4.431814,225,292566,35.93,494.95
1410,4.395918,227,292793,35.93,494.95
1411,4.852706,206,292999,35.92,494.95
1412,4.279353,234,293233,35.94,494.95
1413,4.177280,239,293472,35.93,494.95
1414,4.397736,227,293699,35.94,494.95
1415,4.697483,213,293912,35.93,494.95
1416,4.397758,227,294139,35.94,494.95
1417,4.336585,230,294369,35.94,494.95
1418,4.756492,211,294580,35.94,494.95
1419,4.575574,218,294798,35.96,494.95
1420,4.701185,213,295011,35.95,494.95
1421,4.198462,238,295249,35.94,494.95
1422,4.614966,216,295465,35.94,494.95
1423,4.296864,233,295698,35.95,494.95
1424,4.216453,236,295934,35.95,494.95
1425,4.213031,238,296172,35.94,494.95
1426,4.637346,215,296387,35.94,494.95
1427,4.311555,232,296619,35.95,494.95
1428,4.336205,231,296850,35.95,494.95
1429,4.259736,234,297084,35.96,494.95
1430,4.688559,213,297297,35.95,494.95
1431,4.330392,231,297528,35.95,494.95
1432,4.410909,226,297754,35.96,494.95
1433,4.319192,232,297986,35.96,494.95
1434,4.520527,221,298207,35.95,494.95
1435,4.211383,237,298444,35.97,494.95
1436,4.307697,232,298676,35.97,494.95
1437,4.225108,236,298912,35.97,494.95
1438,4.549615,220,299132,35.98,494.95
1439,4.185818,238,299370,35.98,494.95
1440,4.129659,242,299612,35.99,494.95
1441,4.119073,243,299855,35.98,494.95
1442,4.561235,219,300074,35.97,494.95
1443,4.181268,239,300313,36.00,494.95
1444,4.100774,244,300557,35.99,494.95
1445,4.071589,245,300802,35.99,494.95
1446,4.147721,241,301043,35.99,494.95
1447,4.385153,228,301271,35.98,494.95
1448,4.027208,248,301519,35.99,494.95
1449,4.175196,239,301758,35.99,494.95
1450,4.244383,236,301994,35.98,494.95
1451,4.537566,220,302214,35.99,494.95
1452,4.172041,240,302454,35.99,494.95
1453,4.196735,238,302692,35.98,494.95
1454,4.082434,245,302937,35.98,494.95
1455,4.016209,248,303185,35.99,494.95
1456,4.339739,231,303416,35.98,494.95
1457,3.966697,252,303668,35.99,494.95
1458,4.285278,233,303901,35.98,494.95
1459,5.465315,183,304084,35.97,494.95
1460,6.101109,163,304247,35.97,494.95
1461,5.594489,179,304426,35.97,494.95
1462,6.079039,165,304591,35.97,494.95
1463,5.665384,176,304767,35.99,494.95
1464,5.543730,181,304948,35.98,494.95
1465,5.631584,177,305125,35.99,494.95
1466,5.832349,171,305296,35.97,494.95
1467,5.784367,173,305469,35.97,494.95
1468,4.967123,202,305671,35.96,494.95
1469,4.571862,218,305889,35.97,494.95
1470,4.171990,240,306129,36.00,495.03
1471,4.463283,224,306353,36.01,495.03
1472,4.247505,235,306588,36.03,498.64
1473,4.158624,240,306828,36.02,506.65
1474,4.743246,211,307039,36.03,526.61
1475,4.621566,216,307255,36.05,526.70
1476,5.760734,174,307429,36.06,526.78
1477,4.935028,202,307631,36.08,526.78
1478,5.508714,182,307813,36.07,531.88
1479,5.072423,197,308010,36.08,543.14
1480,5.025198,199,308209,36.08,543.40
1481,5.339690,187,308396,36.08,543.76
1482,4.800985,208,308604,36.09,543.93
1483,5.043787,198,308802,36.08,544.28
1484,4.716484,212,309014,36.09,544.28
1485,4.703656,213,309227,36.10,544.28
1486,5.280509,189,309416,36.09,544.28
1487,4.768323,210,309626,36.10,544.28
1488,5.047283,198,309824,36.09,544.28
1489,4.826662,207,310031,36.12,544.28
1490,4.742719,211,310242,36.11,544.28
1491,5.325429,187,310429,36.10,544.28
1492,5.072999,197,310626,36.11,544.28
1493,5.089279,197,310823,36.11,544.28
1494,5.586580,179,311002,36.13,544.28
1495,5.062158,197,311199,36.12,544.36
1496,5.601254,179,311378,36.12,544.36
1497,5.028522,199,311577,36.13,544.36
1498,5.100842,195,311772,36.13,544.36
1499,5.723018,175,311947,36.13,544.36
1500,5.443669,184,312131,36.14,544.36
1501,5.148141,194,312325,36.13,544.36
1502,5.223035,191,312516,36.13,544.36
1503,4.804623,208,312724,36.15,544.36
1504,4.736675,211,312935,36.14,544.36
1505,7.704657,130,313065,36.15,544.36
1506,4.807818,208,313273,36.14,544.36
1507,4.770352,209,313482,36.14,544.36
1508,5.051479,198,313680,36.15,544.36
1509,4.686514,213,313893,36.15,544.36
1510,4.728675,204,314097,36.14,544.36
1511,5.111717,203,314300,36.15,544.36
1512,4.572268,218,314518,36.16,544.36
1513,5.106193,196,314714,36.15,544.36
1514,4.506820,222,314936,36.16,544.36
1515,4.553334,219,315155,36.15,544.36
1516,5.107339,196,315351,36.15,544.36
1517,4.743880,211,315562,36.16,544.36
1518,4.989827,200,315762,36.15,544.36
1519,6.208981,161,315923,36.16,544.36
1520,5.494506,182,316105,36.16,544.36
1521,5.584838,179,316284,36.15,544.36
1522,6.067931,165,316449,36.16,544.36
1523,5.750867,174,316623,36.17,544.36
1524,5.795451,172,316795,36.16,544.36
1525,5.673640,167,316962,36.16,544.36
1526,6.312778,167,317129,36.17,544.36
1527,6.794884,147,317276,36.17,544.36
1528,5.404797,185,317461,36.17,544.36
1529,5.063751,197,317658,36.16,544.36
1530,4.507801,222,317880,36.18,544.36
1531,4.499180,222,318102,36.17,544.36
1532,5.002312,200,318302,36.17,544.36
1533,4.756916,210,318512,36.17,544.36
1534,4.536862,220,318732,36.17,544.36
1535,4.874113,205,318937,36.19,544.36
1536,4.702095,213,319150,36.18,544.36
1537,4.754646,210,319360,36.17,544.36
1538,4.886343,205,319565,36.18,544.36
1539,4.600303,217,319782,36.17,544.36
1540,4.576854,214,319996,36.17,544.36
1541,4.989920,204,320200,36.19,544.36
1542,4.424674,226,320426,36.18,544.36
1543,4.517756,221,320647,36.17,544.36
1544,4.865407,206,320853,36.18,544.36
1545,4.515961,221,321074,36.19,544.36
1546,4.460403,224,321298,36.18,544.36
1547,4.885234,204,321502,36.19,544.36
1548,4.599374,218,321720,36.18,544.36
1549,4.492953,222,321942,36.17,544.36
1550,4.905048,204,322146,36.19,544.36
1551,4.471139,223,322369,36.19,544.36
1552,4.740694,211,322580,36.18,544.36
1553,5.261020,190,322770,36.19,544.36
1554,4.660324,215,322985,36.19,544.36
1555,4.674959,213,323198,36.18,544.36
1556,5.130181,195,323393,36.18,544.36
1557,4.656096,215,323608,36.19,544.36
1558,4.854359,206,323814,36.20,544.36
1559,5.309193,188,324002,36.19,544.36
1560,4.751663,210,324212,36.20,544.36
1561,4.652518,215,324427,36.19,544.36
1562,4.456411,224,324651,36.19,544.36
1563,4.702052,213,324864,36.19,544.36
1564,4.454313,224,325088,36.19,544.36
1565,4.341062,230,325318,36.19,544.36
1566,4.738803,211,325529,36.19,544.36
1567,4.273151,234,325763,36.20,544.36
1568,4.346249,230,325993,36.20,544.36
1569,4.662392,214,326207,36.19,544.36
1570,4.300038,233,326440,36.20,544.36
1571,4.324661,231,326671,36.19,544.36
1572,4.513232,218,326889,36.18,544.36
1573,4.358422,233,327122,36.21,544.36
1574,4.306476,232,327354,36.20,544.36
1575,4.276612,234,327588,36.19,544.36
1576,5.001070,200,327788,36.19,544.36
1577,4.274306,233,328021,36.20,544.36
1578,4.706323,213,328234,36.19,544.36
1579,6.148615,162,328396,36.18,544.36
1580,5.433799,184,328580,36.19,544.36
1581,5.361884,187,328767,36.19,544.36
1582,5.361344,186,328953,36.20,544.36
1583,5.421452,184,329137,36.19,544.36
1584,5.747542,174,329311,36.20,544.36
1585,5.369601,187,329498,36.21,544.36
1586,5.516812,181,329679,36.20,544.36
1587,5.530415,180,329859,36.19,544.36
1588,5.541499,181,330040,36.18,544.36
1589,4.267807,234,330274,36.20,544.36
1590,4.396163,227,330501,36.19,544.36
1591,4.312777,232,330733,36.18,544.36
1592,4.567560,219,330952,36.19,544.36
1593,4.202981,238,331190,36.20,544.36
1594,4.185419,239,331429,36.19,544.36
1595,4.638078,215,331644,36.18,544.36
1596,4.370833,229,331873,36.19,544.36
1597,4.234180,236,332109,36.19,544.36
1598,4.218870,237,332346,36.18,544.36
1599,4.665243,214,332560,36.18,544.36
1600,4.295211,233,332793,36.19,544.36
1601,4.188106,239,333032,36.18,544.36
1602,4.109170,243,333275,36.17,544.36
1603,4.556901,219,333494,36.17,544.54
1604,4.116348,243,333737,36.19,544.50
1605,4.332507,231,333968,36.18,544.50
1606,4.480538,223,334191,36.18,544.69
1607,4.707353,212,334403,36.18,544.69
1608,4.304968,232,334635,36.18,544.78
1609,4.172055,240,334875,36.17,544.87
1610,4.251082,235,335110,36.16,544.96
1611,4.662875,214,335324,36.17,545.13
1612,4.537121,221,335545,36.16,545.13
1613,4.356359,229,335774,36.17,545.13
1614,4.449487,225,335999,36.16,545.31
1615,4.875067,205,336204,36.16,545.31
1616,4.690123,213,336417,36.16,545.40
1617,4.469158,224,336641,36.17,545.49
1618,4.354589,229,336870,36.17,545.67
1619,4.342439,230,337100,36.16,545.75
1620,4.720241,212,337312,36.17,545.75
1621,4.369564,229,337541,36.17,545.75
1622,4.242315,236,337777,36.16,545.84
1623,4.306899,232,338009,36.18,546.11
1624,4.544310,220,338229,36.20,546.29
1625,4.339387,230,338459,36.20,564.96
1626,4.252489,235,338694,36.22,579.57
1627,4.169638,240,338934,36.21,580.62
1628,4.239299,235,339169,36.21,594.40
1629,4.638701,216,339385,36.22,595.01
1630,4.450179,224,339609,36.21,595.10
1631,4.394470,228,339837,36.22,595.10
1632,4.344012,230,340067,36.21,595.19
1633,4.448916,208,340275,36.22,595.19
1634,4.893600,219,340494,36.22,595.19
1635,4.320344,232,340726,36.22,595.19
1636,4.369501,228,340954,36.23,595.19
1637,4.567850,219,341173,36.24,595.19
1638,4.955651,202,341375,36.26,595.54
1639,6.475635,154,341529,36.28,595.54
1640,6.118646,163,341692,36.27,595.54
1641,5.943128,169,341861,36.28,595.54
1642,6.012780,166,342027,36.29,595.54
1643,6.017703,166,342193,36.28,596.76
1644,6.254479,160,342353,36.29,605.47
1645,6.763084,148,342501,36.28,605.64
1646,6.438218,155,342656,36.29,605.64
1647,6.737970,148,342804,36.30,605.82
1648,5.338653,188,342992,36.30,606.43
1649,4.662051,214,343206,36.30,606.52
1650,4.776565,209,343415,36.31,606.52
1651,4.715622,212,343627,36.30,606.52
1652,4.755367,210,343837,36.30,606.52
1653,5.054255,198,344035,36.32,606.70
1654,4.743703,210,344245,36.31,606.96
1655,4.760884,210,344455,36.31,606.96
1656,4.921989,203,344658,36.32,606.96
1657,4.617715,217,344875,36.31,606.96
1658,4.643786,215,345090,36.32,606.96
1659,5.198023,192,345282,36.32,606.96
1660,4.677266,214,345496,36.32,606.96
1661,4.626927,216,345712,36.33,606.96
1662,4.459594,224,345936,36.32,606.96
1663,4.730021,211,346147,36.31,606.96
1664,4.765845,210,346357,36.33,606.96
1665,4.415355,226,346583,36.32,606.96
1666,5.031984,199,346782,36.33,606.96
1667,4.568973,218,347000,36.35,606.96
1668,4.516238,213,347213,36.36,607.40
1669,5.704572,182,347395,36.38,607.39
1670,5.021977,199,347594,36.38,607.39
1671,5.514565,181,347775,36.38,626.04
1672,5.321586,188,347963,36.39,626.31
1673,5.131634,195,348158,36.39,626.31
1674,5.627081,178,348336,36.40,626.83
1675,5.049942,197,348533,36.39,626.83
1676,5.087609,197,348730,36.40,627.01
1677,5.566519,180,348910,36.41,627.01
1678,5.085622,196,349106,36.41,627.01
1679,5.292334,189,349295,36.42,627.01
1680,5.617855,177,349472,36.41,627.01
1681,5.119479,196,349668,36.42,627.01
1682,5.030137,199,349867,36.43,627.01
1683,5.376064,185,350052,36.42,627.01
1684,5.045137,198,350250,36.43,627.01
1685,4.975856,201,350451,36.42,627.01
1686,5.352516,187,350638,36.43,627.01
1687,5.046445,198,350836,36.42,627.01
1688,4.857260,206,351042,36.43,627.01
1689,5.332696,187,351229,36.44,627.01
1690,4.840363,206,351435,36.43,627.01
1691,4.816252,208,351643,36.44,627.01
1692,5.327592,188,351831,36.45,627.01
1693,4.987236,200,352031,36.44,627.01
1694,4.823458,207,352238,36.43,627.01
1695,5.351433,187,352425,36.46,627.01
1696,4.843121,207,352632,36.45,627.01
1697,4.763667,209,352841,36.44,627.01
1698,5.583821,179,353020,36.44,627.01
1699,6.385543,157,353177,36.46,627.01
1700,6.635197,134,353311,36.45,627.01
1701,8.875204,125,353436,36.44,627.01
1702,6.130768,163,353599,36.43,627.01
1703,6.722809,148,353747,36.45,627.01
1704,6.267735,160,353907,36.45,627.01
1705,6.120117,163,354070,36.44,627.01
1706,6.544867,153,354223,36.44,627.01
1707,6.911493,144,354367,36.45,627.01
1708,5.695907,176,354543,36.45,627.01
1709,4.825606,207,354750,36.46,627.01
1710,5.148085,194,354944,36.46,627.01
1711,4.862954,206,355150,36.46,627.01
1712,4.841258,206,355356,36.46,627.01
1713,5.348863,187,355543,36.46,627.01
1714,4.911292,203,355746,36.46,627.01
1715,4.964344,202,355948,36.46,627.01
1716,5.284333,189,356137,36.45,627.01
1717,4.917203,203,356340,36.46,627.01
1718,5.137572,195,356535,36.46,627.01
1719,4.863460,205,356740,36.46,627.01
1720,5.309082,188,356928,36.46,627.01
1721,4.697682,213,357141,36.46,627.01
1722,4.722412,212,357353,36.47,627.01
1723,5.037463,198,357551,36.47,627.01
1724,4.660562,215,357766,36.46,627.01
1725,4.613778,216,357982,36.46,627.01
1726,5.084171,197,358179,36.47,627.01
1727,4.928148,202,358381,36.47,627.01
1728,4.669347,215,358596,36.46,627.01
1729,4.655839,214,358810,36.47,627.01
1730,5.160230,194,359004,36.47,627.01
1731,4.985719,200,359204,36.47,627.01
1732,4.805828,208,359412,36.46,627.01
1733,5.414803,185,359597,36.49,627.01
1734,4.744313,211,359808,36.48,627.01
1735,4.694315,213,360021,36.48,627.01
1736,4.999332,194,360215,36.47,627.01
1737,4.892289,210,360425,36.50,627.01
1738,4.764974,210,360635,36.49,627.01
1739,4.690580,213,360848,36.49,627.01
1740,5.133808,195,361043,36.49,627.14
1741,4.835206,206,361249,36.49,627.14
1742,4.666767,214,361463,36.50,627.14
1743,4.681202,214,361677,36.49,627.14
1744,5.151457,194,361871,36.50,627.14
1745,4.550146,220,362091,36.50,627.14
1746,4.585289,218,362309,36.50,627.14
1747,5.061436,197,362506,36.50,627.14
1748,4.564041,219,362725,36.50,627.14
1749,4.661635,215,362940,36.50,627.14
1750,4.538122,220,363160,36.50,627.14
1751,4.958316,202,363362,36.51,627.14
1752,4.456246,224,363586,36.50,627.14
1753,4.688803,213,363799,36.50,627.14
1754,4.831487,207,364006,36.50,627.14
1755,4.556303,219,364225,36.51,627.14
1756,4.570296,219,364444,36.50,627.14
1757,4.545358,220,364664,36.50,627.14
1758,5.356851,186,364850,36.50,627.14
1759,5.727063,175,365025,36.50,627.14
1760,5.903080,169,365194,36.50,627.14
1761,5.751536,174,365368,36.50,627.14
1762,5.792564,173,365541,36.50,627.14
1763,6.147858,162,365703,36.51,627.14
1764,5.618664,178,365881,36.50,627.14
1765,5.810496,172,366053,36.50,627.14
1766,5.975297,167,366220,36.50,627.14
1767,6.453300,151,366371,36.50,627.14
1768,5.869854,175,366546,36.51,627.14
1769,4.627013,216,366762,36.51,627.14
1770,4.564333,219,366981,36.50,627.14
1771,4.526238,208,367189,36.49,627.14
1772,4.836171,219,367408,36.52,627.14
1773,4.752695,210,367618,36.51,627.14
1774,4.486455,223,367841,36.50,627.14
1775,5.170701,193,368034,36.50,627.14
1776,4.455774,224,368258,36.51,627.14
1777,4.432523,226,368484,36.51,627.14
1778,4.497501,222,368706,36.50,627.14
1779,4.820938,199,368905,36.50,627.14
1780,4.818895,216,369121,36.50,627.14
1781,4.347127,230,369351,36.50,627.14
1782,4.330788,230,369581,36.49,627.14
1783,4.347828,230,369811,36.50,627.14
1784,4.781134,209,370020,36.49,627.14
1785,4.425013,226,370246,36.49,627.14
1786,4.440993,225,370471,36.50,627.14
1787,4.396636,227,370698,36.49,627.14
1788,4.805117,208,370906,36.49,627.14
1789,4.430295,226,371132,36.50,627.14
1790,4.373374,228,371360,36.50,627.14
1791,4.432837,226,371586,36.49,627.14
1792,4.989165,200,371786,36.49,627.14
1793,4.426790,226,372012,36.50,627.14
1794,4.358370,229,372241,36.50,627.28
1795,4.400504,227,372468,36.51,627.28
1796,4.893386,205,372673,36.50,627.28
1797,4.479748,223,372896,36.51,627.28
1798,4.372830,228,373124,36.50,627.28
1799,4.359003,230,373354,36.50,627.28
1800,4.493366,222,373576,36.50,627.28
1801,4.789939,209,373785,36.50,627.28
1802,4.200540,238,374023,36.51,627.28
1803,4.431172,225,374248,36.50,627.28
1804,4.453408,225,374473,36.49,627.28
1805,4.825009,207,374680,36.49,627.28
1806,4.322706,231,374911,36.51,627.28
1807,4.350060,230,375141,36.50,627.28
1808,4.197823,238,375379,36.50,627.28
1809,4.152205,241,375620,36.49,627.28
1810,4.566827,218,375838,36.48,627.28
1811,4.334111,231,376069,36.50,627.28
1812,4.219598,237,376306,36.49,627.28
1813,4.223794,237,376543,36.49,627.28
1814,4.587055,218,376761,36.49,627.28
1815,4.042877,247,377008,36.49,627.28
1816,4.132937,242,377250,36.48,627.28
1817,4.234656,236,377486,36.49,627.28
1818,4.550522,219,377705,36.48,627.28
1819,5.676054,174,377879,36.47,627.28
1820,5.453496,186,378065,36.48,627.28
1821,5.451144,183,378248,36.49,627.28
1822,5.235305,191,378439,36.48,627.28
1823,5.202149,192,378631,36.47,627.28
1824,5.217393,192,378823,36.48,627.28
1825,5.185734,193,379016,36.48,627.28
1826,6.373440,156,379172,36.48,627.28
1827,5.731157,175,379347,36.48,627.28
1828,5.030608,199,379546,36.47,627.28
1829,4.257369,234,379780,36.47,627.28
1830,4.162839,240,380020,36.47,627.28
1831,4.695923,213,380233,36.47,627.28
1832,4.166592,240,380473,36.48,627.28
1833,4.105739,244,380717,36.47,627.28
1834,4.097679,244,380961,36.46,627.28
1835,4.073158,245,381206,36.46,627.28
1836,4.143554,241,381447,36.46,627.28
1837,4.607897,217,381664,36.48,627.28
1838,3.974679,251,381915,36.51,627.28
1839,4.384070,228,382143,36.51,627.28
1840,4.161612,241,382384,36.51,627.28
1841,4.073723,245,382629,36.50,634.32
1842,4.475817,216,382845,36.51,642.74
1843,4.251356,243,383088,36.51,643.44
1844,4.016472,248,383336,36.50,643.44
1845,4.113141,244,383580,36.52,643.44
1846,4.124889,242,383822,36.52,643.62
1847,4.092773,244,384066,36.54,643.62
1848,4.723077,211,384277,36.56,643.97
1849,4.544822,221,384498,36.57,643.97
1850,4.562530,218,384716,36.57,656.46
1851,4.462151,225,384941,36.57,666.41
1852,4.485629,222,385163,36.57,666.67
1853,4.560752,219,385382,36.58,666.76
1854,4.552063,220,385602,36.58,669.48
1855,5.098216,196,385798,36.58,669.48
1856,4.696920,213,386011,36.60,669.83
1857,4.683659,213,386224,36.60,669.83
1858,4.922078,203,386427,36.59,670.01
1859,4.692540,213,386640,36.61,670.01
1860,4.579252,219,386859,36.61,670.01
1861,4.531146,220,387079,36.60,670.01
1862,4.625771,216,387295,36.62,670.01
1863,5.051057,198,387493,36.61,670.01
1864,4.495681,223,387716,36.61,670.01
1865,4.316352,231,387947,36.61,670.01
1866,4.422529,226,388173,36.63,670.01
1867,4.486526,223,388396,36.62,670.01
1868,4.529659,220,388616,36.61,670.01
1869,4.459813,225,388841,36.63,670.01
1870,4.410958,226,389067,36.62,670.01
1871,4.873517,205,389272,36.61,670.01
1872,4.438033,226,389498,36.64,670.01
1873,4.483752,223,389721,36.63,670.01
1874,4.415017,226,389947,36.62,670.01
1875,4.553648,219,390166,36.64,670.01
1876,4.438802,226,390392,36.63,670.01
1877,4.759493,210,390602,36.63,670.01
1878,4.749904,210,390812,36.64,670.01
1879,5.616459,178,390990,36.63,670.01
1880,6.328470,158,391148,36.64,670.01
1881,5.567309,180,391328,36.66,670.01
1882,6.287463,159,391487,36.68,670.27
1883,6.851701,145,391632,36.70,670.27
1884,6.251918,160,391792,36.69,670.27
1885,6.279267,160,391952,36.68,670.27
1886,6.503489,148,392100,36.69,686.02
1887,7.233479,143,392243,36.70,691.88
1888,5.787236,173,392416,36.69,691.97
1889,4.830039,207,392623,36.70,691.97
1890,5.663140,176,392799,36.70,692.49
1891,5.056972,198,392997,36.71,692.75
1892,5.010470,199,393196,36.70,692.84
1893,4.835580,200,393396,36.70,692.84
1894,5.252686,197,393593,36.71,692.84
1895,4.878844,205,393798,36.71,692.84
1896,4.969026,201,393999,36.71,692.84
1897,5.326750,187,394186,36.72,692.84
1898,4.715218,213,394399,36.72,692.84
1899,4.811546,207,394606,36.71,692.84
1900,5.538855,181,394787,36.71,692.84
1901,4.827907,207,394994,36.73,692.84
1902,4.911006,203,395197,36.72,692.84
1903,5.559590,180,395377,36.71,692.84
1904,5.160474,193,395570,36.72,692.84
1905,4.975771,201,395771,36.73,692.84
1906,4.854858,206,395977,36.72,692.84
1907,5.515543,181,396158,36.72,692.84
1908,4.914832,204,396362,36.71,692.84
1909,4.757984,210,396572,36.73,692.84
1910,5.367254,186,396758,36.72,692.84
1911,8.823720,113,396871,36.72,692.84
1912,5.067545,198,397069,36.71,692.84
1913,5.006869,199,397268,36.73,692.84
1914,5.476155,183,397451,36.72,692.84
1915,4.972517,201,397652,36.73,692.84
1916,5.052370,198,397850,36.72,692.84
1917,4.913237,203,398053,36.73,692.84
1918,5.497549,182,398235,36.74,692.84
1919,4.951078,202,398437,36.74,692.84
1920,4.996498,200,398637,36.73,692.84
1921,5.272859,189,398826,36.74,692.84
1922,4.841372,207,399033,36.76,692.84
1923,4.802014,208,399241,36.75,692.84
1924,4.776823,209,399450,36.74,692.84
1925,5.256396,190,399640,36.76,692.84
1926,4.743843,211,399851,36.76,692.84
1927,4.828546,207,400058,36.75,692.84
1928,5.379353,186,400244,36.75,692.84
1929,4.727179,211,400455,36.76,692.84
1930,4.828233,207,400662,36.75,692.84
1931,4.883895,205,400867,36.75,692.84
1932,5.133920,194,401061,36.74,692.84
1933,4.774917,210,401271,36.76,692.84
1934,4.717172,212,401483,36.75,692.84
1935,4.652730,214,401697,36.75,692.84
1936,5.217628,192,401889,36.76,692.84
1937,4.808788,208,402097,36.76,692.84
1938,5.501056,181,402278,36.75,692.84
1939,5.929192,169,402447,36.75,692.84
1940,6.204671,161,402608,36.77,692.84
1941,5.703916,175,402783,36.76,692.84
1942,5.836572,171,402954,36.76,692.84
1943,5.834671,172,403126,36.76,692.84
1944,6.233578,160,403286,36.75,692.84
1945,5.870102,170,403456,36.76,692.84
1946,6.067368,165,403621,36.77,692.84
1947,5.932201,168,403789,36.77,692.84
1948,5.493639,183,403972,36.77,692.84
1949,5.265348,190,404162,36.77,692.84
1950,4.763929,209,404371,36.77,692.84
1951,4.682162,214,404585,36.77,692.84
1952,4.589767,218,404803,36.78,692.84
1953,5.035839,198,405001,36.78,692.84
1954,4.609069,217,405218,36.77,692.84
1955,4.566737,219,405437,36.76,692.84
1956,4.614541,217,405654,36.78,692.84
1957,5.103826,195,405849,36.78,692.84
1958,4.588324,218,406067,36.77,692.84
1959,4.656468,215,406282,36.77,692.84
1960,4.686665,212,406494,36.76,692.84
1961,5.033934,200,406694,36.79,692.84
1962,4.460726,224,406918,36.78,692.84
1963,4.408454,227,407145,36.77,692.84
1964,4.918122,203,407348,36.76,692.84
1965,4.369153,229,407577,36.78,692.84
1966,4.400438,227,407804,36.79,692.84
1967,4.428926,225,408029,36.78,692.84
1968,4.964690,202,408231,36.77,692.84
1969,4.554961,219,408450,36.77,692.84
1970,4.881248,205,408655,36.78,692.84
1971,4.670408,214,408869,36.78,692.84
1972,4.784383,207,409076,36.78,692.84
1973,4.869844,207,409283,36.78,692.84
1974,4.589921,218,409501,36.78,692.84
1975,4.453794,224,409725,36.78,692.84
1976,4.511109,222,409947,36.78,692.84
1977,4.883791,204,410151,36.79,692.84
1978,4.399786,227,410378,36.79,692.84
1979,4.466955,224,410602,36.78,692.84
1980,4.397258,228,410830,36.79,692.84
1981,4.834215,206,411036,36.80,692.84
1982,4.338783,231,411267,36.80,692.84
1983,4.411780,226,411493,36.79,692.84
1984,4.442179,225,411718,36.80,692.84
1985,4.834372,207,411925,36.80,692.84
1986,4.282403,233,412158,36.79,692.84
1987,4.356540,230,412388,36.78,692.84
1988,4.215597,237,412625,36.79,692.84
1989,4.824979,207,412832,36.79,692.84
1990,4.414039,227,413059,36.80,692.84
1991,4.303873,232,413291,36.81,692.84
1992,4.336693,230,413521,36.83,692.84
1993,4.564797,219,413740,36.82,692.84
1994,4.781733,209,413949,36.84,692.84
1995,4.291617,233,414182,36.84,692.84
1996,4.362190,229,414411,36.83,692.84
1997,4.384516,228,414639,36.83,699.79
1998,4.940253,197,414836,36.83,701.72
1999,5.793941,177,415013,36.84,702.25
2000,5.307577,189,415202,36.84,702.25
2001,5.437929,183,415385,36.85,702.34
2002,5.301930,189,415574,36.84,702.34
2003,5.534933,181,415755,36.84,702.51
2004,5.939548,168,415923,36.86,702.51
2005,5.368684,186,416109,36.86,702.51
2006,5.224197,191,416300,36.85,702.51
2007,5.975063,168,416468,36.84,702.51
2008,5.013082,199,416667,36.86,702.51
2009,4.275524,234,416901,36.86,702.51
2010,4.872822,205,417106,36.86,702.51
2011,4.582859,218,417324,36.86,702.51
2012,4.375419,228,417552,36.86,702.51
2013,4.292031,233,417785,36.85,702.51
2014,4.271899,234,418019,36.85,702.51
2015,4.748842,211,418230,36.87,702.51
2016,4.204406,237,418467,36.86,702.51
2017,4.143493,241,418708,36.85,702.51
2018,4.177432,240,418948,36.86,702.51
2019,4.338415,230,419178,36.85,702.51
2020,4.832037,207,419385,36.85,702.51
2021,4.413949,226,419611,36.86,702.51
2022,4.341257,230,419841,36.85,702.51
2023,4.224376,237,420078,36.86,702.51
2024,4.121706,242,420320,36.86,702.51
2025,4.743355,211,420531,36.86,702.51
2026,4.164326,240,420771,36.86,702.51
2027,4.180666,239,421010,36.86,702.51
2028,4.139273,242,421252,36.86,702.51
2029,4.146579,241,421493,36.85,702.51
2030,4.746565,210,421703,36.86,702.51
2031,4.384534,228,421931,36.87,702.51
2032,4.644541,216,422147,36.86,702.51
2033,4.585317,218,422365,36.87,702.51
2034,4.445596,224,422589,36.87,702.51
2035,4.436545,226,422815,36.86,702.51
2036,5.122724,195,423010,36.87,702.51
2037,4.623723,216,423226,36.87,702.51
2038,4.634617,216,423442,36.87,702.51
2039,4.490133,222,423664,36.86,702.51
2040,4.562051,219,423883,36.88,702.51
2041,4.513314,222,424105,36.88,702.51
2042,4.714621,212,424317,36.88,702.51
2043,4.155473,240,424557,36.88,702.51
2044,4.219921,237,424794,36.88,702.51
2045,4.081730,245,425039,36.87,702.51
2046,4.138857,242,425281,36.86,702.51
2047,4.128437,242,425523,36.87,702.51
2048,4.641911,215,425738,36.87,702.51
2049,4.115660,242,425980,36.87,702.60
2050,4.020829,250,426230,36.87,702.60
2051,4.071177,245,426475,36.88,702.60
2052,3.964416,252,426727,36.87,702.60
2053,4.059186,246,426973,36.87,702.60
2054,4.586386,218,427191,36.87,702.60
2055,4.463027,224,427415,36.88,702.60
2056,4.041356,248,427663,36.87,702.60
2057,3.906767,256,427919,36.86,702.60
2058,4.189868,238,428157,36.87,702.60
2059,5.155015,194,428351,36.86,702.60
2060,5.495036,182,428533,36.86,702.60
2061,5.608151,178,428711,36.85,702.60
2062,5.589615,179,428890,36.88,702.60
2063,5.047331,198,429088,36.88,702.60
2064,5.107538,196,429284,36.87,702.60
2065,5.076731,197,429481,36.87,702.60
2066,5.433774,184,429665,36.87,702.60
2067,5.445321,183,429848,36.87,702.60
2068,4.754066,211,430059,36.87,702.60
2069,4.030632,247,430306,36.86,702.60
2070,4.518493,222,430528,36.86,702.60
2071,4.121225,242,430770,36.87,702.60
2072,4.108054,243,431013,36.86,702.60
2073,4.024198,248,431261,36.86,702.60
2074,4.341450,230,431491,36.87,702.86
2075,4.236269,236,431727,36.90,702.86
2076,4.365172,229,431956,36.90,702.86
2077,4.309247,232,432188,36.91,702.86
2078,4.873136,205,432393,36.90,702.86
2079,4.426666,226,432619,36.92,711.13
2080,4.311050,232,432851,36.92,734.48
2081,4.340852,230,433081,36.92,735.27
2082,4.330251,231,433312,36.91,735.98
2083,4.379900,228,433540,36.92,735.98
2084,4.311622,232,433772,36.92,735.98
2085,4.365256,229,434001,36.91,736.07
2086,4.322822,231,434232,36.91,736.07
2087,4.301674,232,434464,36.92,736.07
2088,4.871587,205,434669,36.93,736.07
2089,4.180255,240,434909,36.92,736.07
2090,4.284655,233,435142,36.93,736.07
2091,4.341618,230,435372,36.94,736.15
2092,4.997413,200,435572,36.97,736.24
2093,4.840813,207,435779,36.98,736.24
2094,4.829773,206,435985,36.97,745.74
2095,5.465599,183,436168,36.98,759.74
2096,4.993675,201,436369,36.97,759.74
2097,4.875164,205,436574,36.99,760.53
2098,4.878836,204,436778,36.98,760.62
2099,5.847665,171,436949,36.99,762.20
2100,4.847386,207,437156,37.00,762.29
2101,4.924215,203,437359,36.99,762.29
2102,5.432976,184,437543,37.01,762.73
2103,4.820888,207,437750,37.00,763.08
2104,4.902343,204,437954,37.01,763.08
2105,4.863959,205,438159,37.00,763.08
2106,5.343758,187,438346,37.00,763.08
2107,4.781608,209,438555,37.00,763.08
2108,4.713196,213,438768,37.01,763.08
2109,5.177901,193,438961,37.01,763.08
2110,4.748626,210,439171,37.01,763.08
2111,4.717359,212,439383,37.00,763.08
2112,4.685770,213,439596,37.00,763.08
2113,5.567677,180,439776,37.02,763.08
2114,4.765664,210,439986,37.01,763.08
2115,4.799879,208,440194,37.01,763.08
2116,4.834857,207,440401,37.01,763.08
2117,5.428917,184,440585,37.01,763.08
2118,5.054569,197,440782,37.01,763.08
2119,6.050300,166,440948,37.01,763.08
2120,6.173224,161,441109,37.02,763.08
2121,6.704992,149,441258,37.02,763.08
2122,12.080526,83,441341,37.01,763.08
2123,6.040056,166,441507,37.01,763.08
2124,6.057695,164,441671,37.01,763.08
2125,6.444730,155,441826,37.00,763.08
2126,6.700203,150,441976,37.01,763.08
2127,6.501538,154,442130,37.04,763.08
2128,5.945774,168,442298,37.05,763.08
2129,5.174138,193,442491,37.06,763.17
2130,4.903513,204,442695,37.05,763.17
2131,5.506561,181,442876,37.07,763.17
2132,4.871328,205,443081,37.06,767.57
2133,4.790043,209,443290,37.07,774.25
2134,4.782337,209,443499,37.06,774.52
2135,5.304648,189,443688,37.08,774.52
2136,4.792876,208,443896,37.08,774.69
2137,4.911928,203,444099,37.07,774.69
2138,4.796653,204,444303,37.07,774.69
2139,5.688117,180,444483,37.08,774.69
2140,4.888993,204,444687,37.08,774.69
2141,4.914881,204,444891,37.08,774.69
2142,4.906443,203,445094,37.07,774.69
2143,5.508574,182,445276,37.09,774.69
2144,4.729958,211,445487,37.09,774.69
2145,4.852306,206,445693,37.09,774.69
2146,4.796128,209,445902,37.08,774.69
2147,5.522556,181,446083,37.09,774.69
2148,4.828379,207,446290,37.10,774.69
2149,4.743465,210,446500,37.09,774.69
2150,4.746728,211,446711,37.09,774.69
2151,5.718131,175,446886,37.09,774.69
2152,4.949382,201,447087,37.10,774.69
2153,5.011583,200,447287,37.10,774.69
2154,4.934768,203,447490,37.11,774.69
2155,5.232551,190,447680,37.10,774.69
2156,5.177718,194,447874,37.11,774.69
2157,5.730474,174,448048,37.10,774.69
2158,5.186030,193,448241,37.12,774.69
2159,4.920479,203,448444,37.11,774.69
2160,5.646261,177,448621,37.11,774.69
2161,4.997047,200,448821,37.12,774.69
2162,4.770625,209,449030,37.12,774.69
2163,4.843462,207,449237,37.12,774.69
2164,4.807018,208,449445,37.12,774.69
2165,5.336015,187,449632,37.11,774.69
2166,4.800277,208,449840,37.13,774.69
2167,4.837765,206,450046,37.12,774.69
2168,4.767547,210,450256,37.12,774.69
2169,5.333036,188,450444,37.12,774.69
2170,4.688728,213,450657,37.13,774.78
2171,4.703074,212,450869,37.13,774.78
2172,4.655130,215,451084,37.12,774.78
2173,4.764395,210,451294,37.12,774.78
2174,5.127256,195,451489,37.13,774.78
2175,4.548264,219,451708,37.13,774.78
2176,4.579973,219,451927,37.13,774.78
2177,4.619051,216,452143,37.13,774.78
2178,5.682388,176,452319,37.14,774.78
2179,5.811684,172,452491,37.14,774.78
2180,5.896284,169,452660,37.13,774.78
2181,6.443441,155,452815,37.13,774.78
2182,6.032091,166,452981,37.13,774.78
2183,6.007703,167,453148,37.14,774.78
2184,6.339452,157,453305,37.14,774.78
2185,5.708851,175,453480,37.15,774.78
2186,6.162273,163,453643,37.14,774.78
2187,5.807546,172,453815,37.14,774.78
2188,5.200777,192,454007,37.14,774.78
2189,4.603171,217,454224,37.14,774.78
2190,5.006775,199,454423,37.15,774.78
2191,4.629508,216,454639,37.15,774.78
2192,4.603324,217,454856,37.15,774.78
2193,4.547509,220,455076,37.15,774.78
2194,5.195184,192,455268,37.14,774.78
2195,4.734314,212,455480,37.15,774.78
2196,4.607441,216,455696,37.16,774.78
2197,4.539453,221,455917,37.15,774.78
2198,4.573692,218,456135,37.15,774.78
2199,5.116055,195,456330,37.14,774.78
2200,4.534590,221,456551,37.15,774.78
2201,4.487443,223,456774,37.16,774.78
2202,4.479976,223,456997,37.15,774.78
2203,4.598142,217,457214,37.15,774.78
2204,5.112216,195,457409,37.15,774.78
2205,4.563590,219,457628,37.15,774.78
2206,4.459276,224,457852,37.16,774.78
2207,4.414006,227,458079,37.16,774.78
2208,4.496223,222,458301,37.15,774.78
2209,5.155151,194,458495,37.15,774.78
2210,4.665606,214,458709,37.16,774.78
2211,5.212175,191,458900,37.15,774.78
2212,4.707040,213,459113,37.16,774.78
2213,4.882094,204,459317,37.15,774.78
2214,4.606586,217,459534,37.16,774.78
2215,5.045050,198,459732,37.16,774.78
2216,4.641925,216,459948,37.16,774.78
2217,4.556516,219,460167,37.16,774.78
2218,4.704396,212,460379,37.18,774.78
2219,4.626871,216,460595,37.17,774.78
2220,5.254918,190,460785,37.17,774.78
2221,4.635568,216,461001,37.17,774.78
2222,4.379067,228,461229,37.17,774.78
2223,4.395515,228,461457,37.17,774.78
2224,4.466356,223,461680,37.18,774.78
2225,4.368884,229,461909,37.17,774.78
2226,4.947849,202,462111,37.16,774.78
2227,4.437018,225,462336,37.17,774.78
2228,4.429388,226,462562,37.18,774.78
2229,4.237605,236,462798,37.17,774.78
2230,4.256043,235,463033,37.16,774.78
2231,4.326286,231,463264,37.17,774.78
2232,4.847617,206,463470,37.18,774.78
2233,4.414467,226,463696,37.18,774.78
2234,4.354679,230,463926,37.17,774.78
2235,4.312998,232,464158,37.17,774.78
2236,4.364855,229,464387,37.19,774.78
2237,5.111161,195,464582,37.23,774.78
2238,4.815495,207,464789,37.25,774.78
2239,8.565319,117,464906,37.25,774.78
2240,6.595169,152,465058,37.26,774.84
2241,6.446248,155,465213,37.26,774.84
2242,6.401157,155,465368,37.25,774.84
2243,6.489014,155,465523,37.26,780.21
2244,7.094421,141,465664,37.26,783.11
2245,6.299187,158,465822,37.27,787.41
2246,6.596792,151,465973,37.26,787.41
2247,6.709408,149,466122,37.26,787.41
2248,5.815107,173,466295,37.26,787.41
2249,5.510125,181,466476,37.26,787.50
2250,4.778212,209,466685,37.26,787.50
2251,4.777249,210,466895,37.27,787.50
2252,4.769085,209,467104,37.27,787.50
2253,5.341245,187,467291,37.27,787.50
2254,4.865691,206,467497,37.27,787.50
2255,4.953662,202,467699,37.26,787.50
2256,4.864757,200,467899,37.27,787.50
2257,5.462702,187,468086,37.28,787.50
2258,4.775007,210,468296,37.28,787.50
2259,4.753102,210,468506,37.27,787.50
2260,5.405763,185,468691,37.28,787.50
2261,4.724561,212,468903,37.28,787.50
2262,4.695232,212,469115,37.28,787.50
2263,4.663333,215,469330,37.27,787.50
2264,5.310924,188,469518,37.28,787.50
2265,4.828052,207,469725,37.28,787.50
2266,4.807336,208,469933,37.27,787.50
2267,7.054898,133,470066,37.27,787.50
2268,5.918987,179,470245,37.27,787.50
2269,5.435095,184,470429,37.28,787.50
2270,4.819998,207,470636,37.27,787.50
2271,4.675062,214,470850,37.27,787.50
2272,4.694930,213,471063,37.27,787.50
2273,5.236172,190,471253,37.28,787.50
2274,4.738798,211,471464,37.28,787.50
2275,4.662321,215,471679,37.27,787.50
2276,4.615417,216,471895,37.29,787.50
2277,5.044450,198,472093,37.30,787.50
2278,4.545119,220,472313,37.29,787.50
2279,4.547227,220,472533,37.29,787.50
2280,4.558732,210,472743,37.30,787.50
2281,5.056256,206,472949,37.30,787.50
2282,4.590643,218,473167,37.30,787.50
2283,4.666562,214,473381,37.30,787.50
2284,4.979498,195,473576,37.29,787.50
2285,4.787956,215,473791,37.31,787.50
2286,4.561578,219,474010,37.30,787.50
2287,4.440931,225,474235,37.30,787.50
2288,4.346353,230,474465,37.29,787.50
2289,5.204241,192,474657,37.30,787.50
2290,4.376708,229,474886,37.31,787.50
2291,4.442460,224,475110,37.30,787.50
2292,4.515563,222,475332,37.29,787.50
2293,5.190723,192,475524,37.30,787.50
2294,4.502896,222,475746,37.30,787.66
2295,4.476169,224,475970,37.30,787.66
2296,4.562633,219,476189,37.29,787.66
2297,5.051815,198,476387,37.29,787.66
2298,4.963180,201,476588,37.31,787.66
2299,5.826517,172,476760,37.31,787.66
2300,5.970079,167,476927,37.30,787.66
2301,5.880365,170,477097,37.30,787.66
2302,6.556506,152,477249,37.29,787.66
2303,6.046045,165,477414,37.31,787.66
2304,5.976403,168,477582,37.30,787.66
2305,5.782173,173,477755,37.30,787.66
2306,6.099662,163,477918,37.30,787.66
2307,5.775771,174,478092,37.30,787.66
2308,5.859957,170,478262,37.31,787.66
2309,4.471675,224,478486,37.31,787.66
2310,4.424646,226,478712,37.31,787.66
2311,4.463698,223,478935,37.31,787.66
2312,5.203500,192,479127,37.33,787.75
2313,5.112278,196,479323,37.36,787.75
2314,4.801502,208,479531,37.35,787.75
2315,4.697973,213,479744,37.35,787.75
2316,4.607203,217,479961,37.35,787.75
2317,5.244751,190,480151,37.34,787.75
2318,4.605056,217,480368,37.37,806.41
2319,4.820373,208,480576,37.36,806.58
2320,4.715836,212,480788,37.35,806.67
2321,4.661630,214,481002,37.35,806.67
2322,5.132421,195,481197,37.37,807.20
2323,4.574530,219,481416,37.37,807.20
2324,4.621737,216,481632,37.36,807.20
2325,4.677481,213,481845,37.36,807.20
2326,4.617012,213,482058,37.36,807.20
2327,5.203762,196,482254,37.37,807.20
2328,4.684404,213,482467,37.37,807.20
2329,4.704968,213,482680,37.37,807.20
2330,4.671532,214,482894,37.37,807.20
2331,4.688854,213,483107,37.36,807.20
2332,5.918803,169,483276,37.36,807.20
2333,4.913151,203,483479,37.39,807.20
2334,4.727001,212,483691,37.38,807.20
2335,4.766897,209,483900,37.37,807.20
2336,4.867522,206,484106,37.37,807.20
2337,5.286394,189,484295,37.37,807.20
2338,4.819711,207,484502,37.38,807.20
2339,4.781732,209,484711,37.39,807.20
2340,4.857831,206,484917,37.38,807.20
2341,4.802782,208,485125,37.39,807.20
2342,5.189943,193,485318,37.38,807.20
2343,4.718766,211,485529,37.39,807.20
2344,4.595911,218,485747,37.39,807.20
2345,4.580942,218,485965,37.40,807.20
2346,4.512910,222,486187,37.39,807.20
2347,4.588953,217,486404,37.38,807.20
2348,5.227909,191,486595,37.39,807.20
2349,4.654234,215,486810,37.39,807.20
2350,4.505289,222,487032,37.40,807.20
2351,4.532852,220,487252,37.39,807.20
2352,4.487934,223,487475,37.39,807.20
2353,5.223219,192,487667,37.39,807.20
2354,4.466199,223,487890,37.39,807.20
2355,4.481957,223,488113,37.40,807.20
2356,4.465669,224,488337,37.39,807.20
2357,4.528855,221,488558,37.40,807.20
2358,4.948194,202,488760,37.39,807.20
2359,6.337860,158,488918,37.39,807.20
2360,5.583587,179,489097,37.39,807.20
2361,5.789610,172,489269,37.39,807.20
2362,5.539616,181,489450,37.40,807.20
2363,5.682324,176,489626,37.40,807.20
2364,5.622806,177,489803,37.40,807.20
2365,6.012545,167,489970,37.39,807.20
2366,6.449771,155,490125,37.40,807.20
2367,5.787728,172,490297,37.40,807.20
2368,5.653770,177,490474,37.40,807.30
2369,4.619689,217,490691,37.41,807.30
2370,4.352794,229,490920,37.40,807.30
2371,4.426518,226,491146,37.40,807.30
2372,4.320958,232,491378,37.40,807.30
2373,5.104721,195,491573,37.41,807.30
2374,4.477398,224,491797,37.40,807.30
2375,4.335802,230,492027,37.41,807.30
2376,4.232975,236,492263,37.41,807.30
2377,4.252264,235,492498,37.41,807.30
2378,4.472785,216,492714,37.40,807.30
2379,5.006995,207,492921,37.40,807.30
2380,4.435218,225,493146,37.41,807.30
2381,4.331296,231,493377,37.41,807.30
2382,4.268360,234,493611,37.41,807.30
2383,4.320815,231,493842,37.40,807.30
2384,4.218998,232,494074,37.40,807.30
2385,4.720303,216,494290,37.41,807.30
2386,4.193997,239,494529,37.40,807.30
2387,4.257657,234,494763,37.41,807.30
2388,4.332251,231,494994,37.40,807.30
2389,4.198247,238,495232,37.41,807.30
2390,4.234734,236,495468,37.41,807.30
2391,5.002894,200,495668,37.41,807.30
2392,4.498151,222,495890,37.40,807.30
2393,4.565253,219,496109,37.40,807.30
2394,4.589743,218,496327,37.41,807.30
2395,4.550004,219,496546,37.41,807.30
2396,4.575894,219,496765,37.41,807.30
2397,4.531647,220,496985,37.40,807.30
2398,5.351673,187,497172,37.42,807.30
2399,4.523612,221,497393,37.42,807.30
2400,4.444001,225,497618,37.42,807.30
2401,4.420293,226,497844,37.41,807.30
2402,4.178336,239,498083,37.42,807.30
2403,4.226541,237,498320,37.42,807.30
2404,4.247593,235,498555,37.42,807.30
2405,5.054711,198,498753,37.41,807.30
2406,4.181998,239,498992,37.41,807.30
2407,4.109041,243,499235,37.41,807.30
2408,4.156240,240,499475,37.41,807.30
2409,4.229862,237,499712,37.42,807.30
2410,4.342996,230,499942,37.42,807.30
2411,4.334445,58,,,
