second,avg_latency_ms_consul_v0.6.4,throughput_consul_v0.6.4,cumulative_throughput_consul_v0.6.4,avg_cpu_consul_v0.6.4,avg_memory_mb_consul_v0.6.4
0,86.400579,9168,9168,1.70,16.53
1,95.051143,10971,20139,33.25,56.25
2,107.544941,9373,29512,58.26,73.96
3,114.598946,8642,38154,77.00,92.57
4,111.507587,9145,47299,91.90,98.56
5,106.367149,9218,56517,104.08,117.01
6,112.109653,8980,65497,115.19,136.11
7,109.212430,9291,74788,124.48,129.42
8,110.167855,9063,83851,132.90,148.92
9,107.243264,9298,93149,139.49,171.26
10,112.598242,8844,101993,146.63,192.33
11,110.244271,9122,111115,152.16,212.19
12,109.778010,8976,120091,157.16,233.15
13,102.018125,9984,130075,160.90,248.54
14,109.831349,9045,139120,165.83,212.70
15,100.866838,9899,149019,170.07,233.59
16,113.764015,8387,157406,174.05,257.15
17,112.827907,9253,166659,177.21,273.77
18,108.929543,9258,175917,179.69,290.49
19,111.460857,8994,184911,182.42,310.69
20,102.061340,9773,194684,184.95,333.82
21,104.893923,9539,204223,187.74,350.81
22,104.004812,9535,213758,190.09,371.61
23,111.527553,9042,222800,192.63,397.49
24,110.537846,9052,231852,195.01,416.95
25,124.312945,7879,239731,196.52,430.06
26,124.153330,8269,248000,197.99,449.18
27,125.456275,7785,255785,199.32,469.90
28,110.277909,9084,264869,199.97,487.77
29,120.882429,8328,273197,201.25,397.66
30,122.322485,8203,281400,201.80,413.82
31,128.411505,7727,289127,202.95,430.88
32,104.687619,9488,298615,203.72,449.87
33,125.099355,7991,306606,204.68,470.01
34,119.842366,8334,314940,205.14,479.27
35,104.410162,9701,324641,205.85,501.00
36,111.086746,9038,333679,207.19,522.16
37,108.885583,9149,342828,208.06,537.20
38,98.945369,10031,352859,209.50,558.38
39,110.225965,9053,361912,210.29,577.91
40,114.944285,8694,370606,211.13,596.39
41,98.998576,10171,380777,211.79,615.87
42,119.146758,8305,389082,213.13,637.99
43,109.802617,8563,397645,213.44,649.42
44,119.018115,8985,406630,213.94,669.90
45,114.863769,8696,415326,214.36,685.15
46,113.926534,8671,423997,215.29,704.37
47,134.494440,7610,431607,215.20,718.27
48,105.848915,9355,440962,215.76,739.77
49,123.846241,8117,449079,216.23,754.66
50,98.787979,10126,459205,217.10,777.86
51,115.046920,8671,467876,217.94,795.67
52,106.142399,9371,477247,218.37,817.80
53,118.889499,8402,485649,219.11,831.64
54,101.749646,9858,495507,219.68,851.51
55,115.229354,8562,504069,220.29,868.46
56,94.939447,10254,514323,220.85,882.28
57,124.575323,8437,522760,221.59,907.69
58,101.260264,9763,532523,221.86,697.33
59,117.276194,8511,541034,222.41,724.13
60,95.731631,10495,551529,222.88,738.41
61,129.324673,7690,559219,223.43,764.81
62,99.836570,10009,569228,223.36,769.89
63,126.021014,7912,577140,224.14,795.87
64,96.540708,10335,587475,224.45,811.09
65,101.862292,9911,597386,224.92,827.25
66,120.362147,8282,605668,225.51,854.81
67,94.511996,9937,615605,225.34,858.52
68,125.882246,8347,623952,226.35,891.20
69,102.440523,9750,633702,226.53,901.82
70,105.287831,9650,643352,226.81,920.39
71,128.332030,7760,651112,227.52,950.01
72,96.587576,10057,661169,227.34,954.51
73,108.026856,7700,668869,227.84,975.87
74,119.188043,10010,678879,228.35,1000.89
75,99.143639,10149,689028,228.24,1005.11
76,144.984142,6765,695793,228.64,1037.12
77,102.450582,9884,705677,229.19,1049.87
78,109.699359,9060,714737,229.01,1056.02
79,149.087008,6753,721490,229.08,1085.36
80,96.796799,10355,731845,229.53,1106.54
81,103.664101,8742,740587,229.59,1113.16
82,151.417763,6956,747543,229.70,1147.73
83,93.912139,11181,758724,230.23,1165.81
84,93.795630,10334,769058,230.24,1172.40
85,145.324553,6848,775906,230.67,1203.83
86,104.164647,9776,785682,231.08,1221.93
87,104.592498,9423,795105,230.99,1228.29
88,138.168267,7349,802454,230.95,1248.65
89,98.489842,10194,812648,231.28,1267.76
90,102.320839,9706,822354,231.68,1282.30
91,139.160198,7247,829601,231.68,1302.22
92,101.270732,9812,839413,231.85,1321.42
93,96.390576,10392,849805,232.24,1342.15
94,153.879511,6411,856216,232.10,1362.19
95,94.434202,10741,866957,232.07,1365.90
96,107.730310,9210,876167,232.55,1390.34
97,146.545076,6581,882748,232.60,1412.01
98,168.113814,6213,888961,232.07,1432.43
99,93.127777,10722,899683,231.95,1441.84
100,111.747061,9003,908686,232.39,1463.15
101,109.733577,7722,916408,232.71,1484.19
102,120.205527,9406,925814,232.78,1498.53
103,94.283566,10843,936657,232.70,1503.97
104,144.142520,6598,943255,233.07,1539.66
105,220.542829,3674,946929,232.71,1557.32
106,124.504688,9897,956826,232.59,1566.48
107,93.761040,10629,967455,232.56,1573.06
108,117.713218,8325,975780,232.72,1593.98
109,156.786527,6502,982282,233.50,1632.71
110,100.599201,9933,992215,233.46,1637.68
111,101.877029,9859,1002074,233.41,1644.90
112,103.649348,8129,1010203,233.33,1663.44
113,174.532227,6632,1016835,233.80,1701.66
114,95.581186,10345,1027180,234.19,1710.16
115,105.134775,9606,1036786,234.04,1715.20
116,106.995208,7269,1044055,233.92,1295.86
117,132.941499,8221,1052276,234.20,1325.03
118,104.452374,10812,1063088,234.84,1348.56
119,95.971991,10256,1073344,234.77,1355.21
120,129.319203,7124,1080468,234.63,1376.02
121,100.498874,10229,1090697,234.70,1383.09
122,116.529140,9128,1099825,235.26,1425.77
123,99.187200,10086,1109911,235.42,1434.17
124,106.759688,7589,1117500,235.36,1449.05
125,146.113111,8182,1125682,235.33,1460.03
126,97.349479,9956,1135638,235.19,1478.89
127,143.903062,6984,1142622,235.79,1513.04
128,131.559512,7523,1150145,235.52,1519.30
129,156.524331,4849,1154994,235.03,1543.46
130,127.369906,9798,1164792,235.13,1548.89
131,97.551191,9905,1174697,235.02,1559.38
132,153.451125,6704,1181401,235.60,1598.58
133,162.439687,6091,1187492,235.16,1606.00
134,158.840625,5555,1193047,234.53,1620.83
135,151.748188,7528,1200575,234.54,1631.56
136,95.901328,10496,1211071,234.37,1636.25
137,138.192625,6775,1217846,234.50,1659.59
138,245.748314,4069,1221915,233.98,1683.42
139,203.469617,5003,1226918,233.60,1687.89
140,178.851813,4560,1231478,232.92,1704.90
141,146.405180,8342,1239820,232.91,1711.76
142,95.289911,10310,1250130,232.85,1717.15
143,126.351909,8066,1258196,232.77,1739.99
144,212.171286,4429,1262625,232.61,1755.78
145,150.173252,7080,1269705,232.41,1774.47
146,180.992373,5547,1275252,232.50,1794.96
147,107.664947,9237,1284489,232.29,1800.06
148,107.347446,9343,1293832,232.13,1806.83
149,107.934251,9318,1303150,231.96,1813.17
150,133.563325,7455,1310605,232.07,1840.29
151,169.469462,5926,1316531,232.25,1882.32
152,114.530408,8471,1325002,232.57,1887.37
153,110.557617,9320,1334322,232.39,1894.31
154,111.971457,8768,1343090,232.22,1902.69
155,106.797456,8681,1351771,232.11,1919.87
156,156.350586,6996,1358767,232.26,1952.93
157,117.232743,8559,1367326,232.58,1981.39
158,90.535826,10864,1378190,232.96,1989.71
159,99.108737,10239,1388429,232.92,1994.97
160,98.771857,9038,1397467,232.90,2017.26
161,159.930239,6823,1404290,232.98,2024.56
162,94.611745,10746,1415036,233.38,2051.81
163,191.550954,4988,1420024,233.47,2084.04
164,175.108578,5699,1425723,232.94,2088.35
165,174.622135,5737,1431460,232.38,2094.17
166,177.406811,5633,1437093,231.84,2104.87
167,243.280123,4274,1441367,231.65,2126.88
168,104.148050,9455,1450822,231.56,2131.83
169,95.806767,10165,1460987,231.60,2156.18
170,155.868647,6549,1467536,232.18,2190.90
171,157.472202,6330,1473866,231.85,2198.62
172,157.586470,6192,1480058,231.43,2204.75
173,169.435910,4100,1484158,231.15,2227.27
174,141.877227,9452,1493610,231.31,2230.45
175,99.266291,10200,1503810,231.54,2234.96
176,186.179205,5004,1508814,232.24,2301.58
177,233.382220,4202,1513016,232.13,2305.94
178,218.456623,4780,1517796,231.79,2310.06
179,201.416763,4933,1522729,231.51,2314.38
180,200.908728,4939,1527668,231.23,2324.16
181,256.755137,4117,1531785,231.40,2345.00
182,160.094097,5736,1537521,231.76,2423.50
183,207.290438,4999,1542520,232.07,2428.90
184,201.487237,4919,1547439,231.76,2433.20
185,241.893104,4022,1551461,231.40,2570.70
186,255.336002,3862,1555323,230.96,2820.01
187,257.076348,1136,1556459,230.30,3119.48
188,0.000000,0,1556459,229.83,3299.39
189,2698.950773,77,1556536,229.06,3418.07
190,3447.273320,533,1557069,228.97,3605.74
191,3942.671463,447,1557516,228.08,3758.56
192,1769.593997,991,1558507,228.11,3816.75
193,1114.207889,347,1558854,227.15,3816.75
194,1673.403147,653,1559507,227.06,3818.80
195,2365.856781,106,1559613,226.04,3818.80
196,2434.782784,816,1560429,225.52,3818.80
197,2283.553793,92,1560521,224.50,3818.80
198,2952.041997,13,1560534,223.46,3818.80
199,3883.511080,8,1560542,222.42,3818.80
200,4826.619362,15,1560557,221.82,3818.80
201,5712.257962,45,1560602,220.81,3818.80
202,6378.280493,42,1560644,220.40,3822.30
203,6976.951001,29,1560673,219.54,3848.42
204,8139.577232,17,1560690,218.70,3874.12
205,8985.871087,39,1560729,218.30,3878.92
206,9956.756734,125,1560854,217.47,3878.92
207,10833.392877,193,1561047,216.65,3878.92
208,11665.980081,163,1561210,215.84,3878.92
209,0.000000,0,1561210,215.08,3878.92
210,13894.131704,27,1561237,214.28,3962.80
211,0.000000,0,1561237,213.57,4251.26
212,0.000000,0,1561237,212.88,4258.14
213,16669.881545,3,1561240,211.96,4267.69
214,0.000000,0,1561240,210.91,4267.79
215,0.000000,0,1561240,210.05,4267.79
216,19900.300496,17,1561257,209.19,4274.12
217,0.000000,0,1561257,208.33,4274.12
218,0.000000,0,1561257,207.62,4274.12
219,0.000000,0,1561257,206.70,4274.12
220,23329.637435,2,1561259,205.79,4274.12
221,0.000000,0,1561259,204.86,4280.53
222,0.000000,0,1561259,204.07,4280.53
223,27089.369386,42,1561301,203.30,4280.53
224,0.000000,0,1561301,202.43,4286.95
225,0.000000,0,1561301,201.54,4286.95
226,0.000000,0,1561301,200.65,4286.95
227,30435.603796,1,1561302,199.80,4286.95
228,0.000000,0,1561302,198.74,4290.14
229,32898.480074,64,1561366,198.02,4290.14
230,33258.624294,95,1561461,197.32,4302.95
231,34304.963378,19,1561480,196.53,4345.68
232,35180.930393,31,1561511,196.14,4354.17
233,36018.850644,8,1561519,195.69,4354.17
234,36168.459995,12,1561531,195.26,4354.17
235,36540.670507,8,1561539,194.49,4354.17
236,36179.820119,17,1561556,193.71,4354.17
237,36107.509669,38,1561594,192.94,4356.33
238,36082.647425,49,1561643,192.19,4391.33
239,36090.077860,30,1561673,191.45,4426.46
240,36075.015226,17,1561690,190.70,4461.73
241,36087.623114,39,1561729,189.96,4491.23
242,36063.424223,124,1561853,189.24,4525.62
243,33510.323449,448,1562301,188.85,4538.24
244,14452.972818,153,1562454,188.15,4538.24
245,14310.616765,25,1562479,187.60,4538.24
246,14258.859239,31,1562510,187.31,4538.33
247,14163.492770,8,1562518,186.70,4538.33
248,14128.928526,13,1562531,185.99,4538.33
249,13281.020301,19,1562550,185.29,4538.33
250,13168.318252,43,1562593,184.60,4538.33
251,13175.912061,49,1562642,184.24,4538.42
252,13182.293382,29,1562671,183.55,4538.42
253,13182.286631,15,1562686,182.87,4538.42
254,13183.583704,40,1562726,182.19,4538.42
255,13197.146083,123,1562849,181.53,4538.42
256,13180.975668,389,1563238,180.87,4538.42
257,13305.200901,129,1563367,180.24,4538.42
258,13763.361143,91,1563458,179.93,4538.42
259,13989.259740,20,1563478,179.94,4538.42
260,14022.076837,32,1563510,179.29,4538.42
261,14017.002135,8,1563518,178.65,4538.42
262,14042.519212,9,1563527,178.00,4538.42
263,14324.857947,19,1563546,177.37,4538.42
264,14412.905860,14,1563560,176.74,4538.42
265,14373.599793,54,1563614,176.11,4538.42
266,14363.052469,52,1563666,175.50,4538.42
267,14363.334373,10,1563676,174.89,4538.42
268,14355.543111,42,1563718,174.41,4538.42
269,14348.214587,71,1563789,173.98,4538.42
270,14348.586525,257,1564046,173.70,4538.42
271,14346.639616,259,1564305,173.45,4538.50
272,14598.104446,64,1564369,172.86,4538.50
273,15005.364039,89,1564458,172.28,4538.50
274,15019.885515,20,1564478,171.69,4538.50
275,15029.043047,31,1564509,171.11,4538.50
276,15034.561715,9,1564518,170.80,4538.50
277,15039.277206,9,1564527,170.26,4538.50
278,15080.634862,18,1564545,169.69,4538.50
279,15175.972696,13,1564558,169.12,4538.50
280,15328.819279,52,1564610,168.55,4538.50
281,15398.282648,34,1564644,167.99,4538.50
282,15394.390432,29,1564673,167.72,4538.50
283,15439.920835,17,1564690,167.47,4538.50
284,15388.057173,42,1564732,166.92,4538.50
285,15383.937802,122,1564854,166.37,4538.55
286,15466.886311,448,1565302,166.14,4538.55
287,15441.383673,58,1565360,165.63,4538.55
288,15532.749580,70,1565430,165.09,4538.55
289,15348.623533,34,1565464,164.55,4538.55
290,15363.187025,18,1565482,164.02,4538.55
291,15563.972166,33,1565515,163.49,4538.55
292,15353.222452,7,1565522,162.97,4538.55
293,15469.357023,11,1565533,162.45,4538.55
294,15601.607180,15,1565548,162.18,4538.55
295,15762.278979,13,1565561,161.85,4538.55
296,15751.604222,52,1565613,161.48,4541.38
297,15674.754488,52,1565665,160.98,4541.38
298,15738.304675,11,1565676,160.76,4541.38
299,15671.879721,17,1565693,160.25,4541.38
300,15710.753697,94,1565787,159.75,4541.38
301,15739.215377,195,1565982,159.26,4541.38
302,15867.178183,289,1566271,158.77,4541.38
303,15817.464826,97,1566368,158.30,4541.38
304,15684.495496,64,1566432,157.81,4541.38
305,15706.543611,46,1566478,157.33,4541.38
306,15566.208868,32,1566510,156.84,4541.38
307,15559.551344,10,1566520,156.65,4541.38
308,15381.152296,9,1566529,156.43,4541.38
309,15423.083083,11,1566540,155.96,4541.38
310,15371.321443,18,1566558,155.77,4541.38
311,15435.739561,37,1566595,155.30,4541.38
312,15336.303266,69,1566664,154.84,4541.38
313,15213.577091,10,1566674,154.37,4541.38
314,15258.902365,17,1566691,153.91,4541.38
315,15138.072461,63,1566754,153.45,4541.38
316,15137.665744,164,1566918,153.00,4541.38
317,15107.297489,353,1567271,152.56,4541.38
318,14978.518488,99,1567370,152.13,4541.38
319,14964.508791,91,1567461,151.95,4541.38
320,14849.039152,20,1567481,151.78,4541.38
321,14779.002329,31,1567512,151.34,4541.65
322,14739.653919,9,1567521,151.00,4541.65
323,14690.791706,12,1567533,150.72,4541.65
324,14696.218956,15,1567548,150.28,4541.65
325,14592.872167,14,1567562,149.85,4541.65
326,14577.598729,55,1567617,149.42,4541.65
327,14568.651721,52,1567669,149.00,4541.65
328,14437.332229,18,1567687,148.57,4541.65
329,14377.444084,41,1567728,148.15,4541.65
330,14365.908308,67,1567795,147.73,4541.65
331,14325.181332,317,1568112,147.56,4541.65
332,14412.422213,249,1568361,147.42,4541.65
333,14242.841316,75,1568436,147.11,4541.65
334,14204.268624,43,1568479,146.79,4541.65
335,14126.660872,31,1568510,146.74,4541.65
336,14031.404982,12,1568522,146.43,4541.65
337,14021.047239,9,1568531,146.11,4541.65
338,14042.325844,17,1568548,145.80,4541.65
339,13900.688599,14,1568562,145.77,4541.65
340,13925.535339,54,1568616,145.45,4541.65
341,13779.470276,53,1568669,145.15,4541.65
342,13957.698699,20,1568689,144.77,4542.92
343,13908.156066,42,1568731,144.49,4542.92
344,14010.997738,64,1568795,144.25,4542.92
345,13942.922458,381,1569176,143.86,4542.92
346,14114.260094,183,1569359,143.49,4542.92
347,14035.541642,72,1569431,143.36,4542.92
348,14052.023532,48,1569479,143.23,4542.92
349,14048.283483,31,1569510,142.85,4542.92
350,14071.817024,12,1569522,142.47,4542.92
351,14006.278566,11,1569533,142.08,4542.92
352,14013.076357,12,1569545,141.71,4542.92
353,14099.500328,17,1569562,141.33,4542.92
354,14100.455507,55,1569617,140.96,4542.92
355,14019.660345,53,1569670,140.59,4542.92
356,14010.149404,9,1569679,140.47,4542.92
357,14047.197814,50,1569729,140.10,4542.92
358,13924.633920,131,1569860,139.74,4542.92
359,13971.043378,255,1570115,139.45,4542.92
360,14061.437504,192,1570307,139.48,4549.33
361,14115.203682,129,1570436,139.15,4549.33
362,13935.588830,45,1570481,138.80,4549.33
363,13861.418593,31,1570512,138.44,4549.33
364,13854.680175,11,1570523,138.08,4549.33
365,13814.618393,12,1570535,137.73,4549.33
366,13736.657928,17,1570552,137.38,4549.33
367,13755.987552,13,1570565,137.02,4549.33
368,13710.851367,80,1570645,136.92,4549.33
369,13780.856989,28,1570673,136.56,4549.33
370,13623.963101,18,1570691,136.21,4549.33
371,13589.062744,64,1570755,135.84,4549.33
372,13595.239995,291,1571046,135.77,4549.33
373,13454.738792,197,1571243,135.47,4549.33
374,13559.444236,129,1571372,135.13,4549.33
375,13477.227226,96,1571468,134.80,4549.33
376,13364.118695,20,1571488,134.46,4549.33
377,13327.082118,32,1571520,134.11,4549.33
378,13310.819658,10,1571530,133.76,4549.33
379,13256.419143,15,1571545,133.43,4549.33
380,13197.064691,19,1571564,133.32,4549.33
381,13274.084012,80,1571644,133.01,4549.33
382,13159.229774,29,1571673,132.67,4549.33
383,13052.244319,19,1571692,132.35,4549.33
384,13147.289229,43,1571735,132.29,4549.33
385,13000.904742,255,1571990,132.09,4549.33
386,13087.310055,251,1572241,131.86,4549.33
387,13215.637444,121,1572362,131.62,4549.33
388,13249.375568,78,1572440,131.65,4549.33
389,13138.399247,48,1572488,131.46,4549.33
390,13062.071656,32,1572520,131.23,4549.33
391,13034.464855,11,1572531,131.00,4549.33
392,13048.118159,14,1572545,130.74,4550.17
393,13154.233876,16,1572561,130.43,4550.17
394,13171.935890,55,1572616,130.17,4550.17
395,13172.856470,55,1572671,130.04,4550.17
396,13147.065098,10,1572681,129.98,4550.17
397,13112.296147,52,1572733,129.88,4550.17
398,13228.625997,130,1572863,129.58,4550.17
399,13229.423772,377,1573240,129.28,4550.17
400,13135.489024,105,1573345,128.99,4550.17
401,13127.277226,96,1573441,128.69,4550.17
402,13162.624435,45,1573486,128.39,4550.17
403,13069.156735,30,1573516,128.10,4550.17
404,13040.187822,13,1573529,127.81,4550.17
405,12994.823417,16,1573545,127.51,4550.17
406,12991.632643,16,1573561,127.28,4550.17
407,12956.104800,54,1573615,127.13,4550.17
408,12994.462842,57,1573672,127.03,4550.17
409,12949.825355,19,1573691,126.98,4550.17
410,13084.321113,42,1573733,126.69,4550.17
411,13092.832541,124,1573857,126.41,4550.17
412,13265.809668,253,1574110,126.13,4550.17
413,13278.034733,136,1574246,125.85,4550.17
414,13335.029735,64,1574310,125.57,4550.17
415,14994.690258,35,1574345,125.28,4550.17
416,15032.613508,95,1574440,125.00,4550.17
417,15020.857423,46,1574486,124.72,4550.17
418,15025.323764,32,1574518,124.44,4550.17
419,15133.718124,9,1574527,124.36,4550.17
420,15105.120016,15,1574542,124.08,4550.17
421,15072.830030,15,1574557,123.93,4550.17
422,15100.876167,58,1574615,123.74,4550.17
423,15148.634115,56,1574671,123.46,4550.17
424,15076.617741,11,1574682,123.17,4550.17
425,15080.509587,48,1574730,122.88,4550.17
426,15086.106528,127,1574857,122.60,4550.17
427,15133.878183,224,1575081,122.34,4550.17
428,15159.160293,165,1575246,122.08,4550.17
429,14412.788389,118,1575364,121.80,4550.17
430,13878.217467,77,1575441,121.57,4550.17
431,13911.552016,46,1575487,121.52,4550.17
432,14007.435041,29,1575516,121.27,4550.17
433,14070.469073,12,1575528,121.00,4550.17
434,14072.624040,14,1575542,120.94,4550.36
435,14096.525425,15,1575557,120.67,4550.36
436,14039.549247,58,1575615,120.40,4550.36
437,13980.273874,55,1575670,120.15,4550.36
438,13995.453845,11,1575681,119.89,4550.36
439,13971.001554,51,1575732,119.64,4550.36
440,13977.836668,63,1575795,119.38,4550.36
441,14049.941204,247,1576042,119.14,4550.36
442,14062.846722,204,1576246,119.09,4550.36
443,13987.864946,102,1576348,118.90,4550.36
444,14095.245073,92,1576440,118.78,4550.36
445,13972.859792,47,1576487,118.53,4550.36
446,14059.663831,29,1576516,118.47,4550.36
447,13938.978134,12,1576528,118.23,4550.36
448,14000.676095,15,1576543,118.00,4550.36
449,13978.112848,15,1576558,117.83,4550.36
450,14018.960381,57,1576615,117.66,4550.36
451,13958.419337,56,1576671,117.49,4550.36
452,13965.049523,10,1576681,117.32,4550.36
453,13960.590717,49,1576730,117.18,4550.36
454,14050.943669,66,1576796,117.35,4550.36
455,14038.819005,200,1576996,117.19,4550.36
456,14124.790616,250,1577246,117.21,4550.36
457,14142.741427,103,1577349,117.01,4550.36
458,14073.080751,91,1577440,116.78,4550.36
459,14081.346310,47,1577487,116.54,4550.36
460,14086.625545,29,1577516,116.30,4550.36
461,14051.752026,11,1577527,116.07,4550.36
462,14133.286484,14,1577541,115.86,4550.36
463,14135.992582,17,1577558,115.80,4550.36
464,14027.627708,57,1577615,115.57,4550.36
465,14069.356170,55,1577670,115.34,4550.36
466,14063.299436,12,1577682,115.13,4550.36
467,14139.759383,51,1577733,115.06,4550.36
468,14048.785929,63,1577796,115.00,4550.36
469,14140.871546,198,1577994,114.79,4550.36
470,14155.147970,183,1578177,114.57,4550.36
471,14229.673498,171,1578348,114.35,4550.36
472,14114.060356,92,1578440,114.13,4550.36
473,14067.638909,47,1578487,113.91,4550.36
474,14065.408359,29,1578516,113.68,4550.36
475,14078.980007,12,1578528,113.64,4550.36
476,14075.304751,11,1578539,113.41,4550.36
477,14039.662039,19,1578558,113.19,4550.36
478,13939.812979,57,1578615,112.97,4550.36
479,13979.041916,57,1578672,112.92,4550.36
480,13906.627374,10,1578682,112.71,4550.36
481,13924.464990,13,1578695,112.66,4550.36
482,14630.035539,43,1578738,112.44,4550.36
483,0.000000,0,1578738,112.22,4550.36
484,0.000000,0,1578738,112.01,4550.36
485,15155.386486,506,1579244,111.81,4550.36
486,0.000000,0,1579244,111.59,4550.36
487,0.000000,0,1579244,111.38,4550.36
488,15999.920844,269,1579513,111.16,4550.36
489,0.000000,0,1579513,110.92,4550.36
490,0.000000,0,1579513,110.75,4550.36
491,0.000000,0,1579513,110.73,4550.36
492,0.000000,0,1579513,110.53,4550.36
493,0.000000,0,1579513,110.48,4550.36
494,0.000000,0,1579513,110.27,4550.36
495,0.000000,0,1579513,110.05,4550.36
496,15416.395362,313,1579826,109.81,4550.36
497,0.000000,0,1579826,109.61,4550.36
498,0.000000,0,1579826,109.39,4550.36
499,0.000000,0,1579826,109.18,4550.36
500,0.000000,0,1579826,108.94,4550.36
501,0.000000,0,1579826,108.76,4550.36
502,0.000000,0,1579826,108.59,4550.36
503,18793.389332,195,1580021,108.38,4550.36
504,17597.788154,455,1580476,108.19,4550.36
505,6754.961669,583,1581059,108.01,4550.36
506,1937.465059,519,1581578,107.84,4550.36
507,1859.822578,260,1581838,107.76,4550.36
508,2180.238905,650,1582488,107.78,4550.36
509,2023.762186,390,1582878,107.81,4550.36
510,2008.302652,520,1583398,107.63,4550.36
511,1882.133605,650,1584048,107.46,4550.36
512,1739.538843,129,1584177,107.29,4550.36
513,2538.385176,454,1584631,107.10,4550.36
514,3182.400822,195,1584826,106.92,4550.36
515,3592.688454,260,1585086,106.82,4550.36
516,3670.073501,261,1585347,106.71,4550.36
517,3883.116961,259,1585606,106.66,4550.36
518,3948.926602,261,1585867,106.50,4550.36
519,4013.372973,220,1586087,106.31,4550.36
520,4020.129055,260,1586347,106.22,4550.36
521,3982.266366,260,1586607,106.12,4550.36
522,4146.579417,195,1586802,105.94,4550.36
523,4138.283456,284,1587086,105.76,4550.36
524,4113.032554,212,1587298,105.59,4550.36
525,3996.033444,309,1587607,105.41,4550.36
526,4031.165515,196,1587803,105.23,4550.36
527,4056.070577,220,1588023,105.05,4550.36
528,4170.466995,260,1588283,105.03,4550.36
529,4234.415153,261,1588544,104.97,4550.36
530,4324.699248,194,1588738,104.84,4550.36
531,4245.787093,197,1588935,104.67,4550.36
532,4397.756440,281,1589216,104.54,4550.36
533,4366.544073,198,1589414,104.48,4550.36
534,4494.528026,195,1589609,104.30,4550.36
535,4453.044748,260,1589869,104.13,4550.36
536,4536.989081,153,1590022,103.96,4550.36
537,4692.697733,261,1590283,103.78,4550.36
538,4941.877662,132,1590415,103.61,4550.36
539,4868.707519,258,1590673,103.44,4550.36
540,4839.601343,198,1590871,103.42,4550.36
541,4754.262224,215,1591086,103.27,4550.36
542,4794.848377,199,1591285,103.25,4550.36
543,4875.338519,194,1591479,103.13,4550.36
544,4863.625035,259,1591738,103.02,4550.36
545,5089.858231,133,1591871,103.07,4550.36
546,5079.016045,215,1592086,102.96,4550.36
547,5282.391740,134,1592220,102.85,4550.36
548,5263.541999,195,1592415,102.89,4550.36
549,5271.602639,258,1592673,102.80,4550.36
550,5240.174011,146,1592819,102.69,4550.36
551,5355.611500,182,1593001,102.56,4550.36
552,5479.601238,89,1593090,102.55,4550.36
553,5435.522462,263,1593353,102.39,4550.36
554,5343.065174,197,1593550,102.22,4550.36
555,5361.435432,191,1593741,102.06,4550.36
556,5472.383571,134,1593875,101.90,4550.36
557,5533.344406,213,1594088,101.97,4550.36
558,5536.903380,135,1594223,101.88,4550.36
559,5605.651161,133,1594356,101.72,4550.36
560,5876.138031,255,1594611,101.55,4550.36
561,5842.274950,194,1594805,101.39,4550.36
562,5791.187716,132,1594937,101.23,4550.36
563,5840.441744,151,1595088,101.07,4550.36
564,5821.383580,137,1595225,101.06,4550.36
565,5936.980984,132,1595357,100.91,4550.36
566,5944.583789,256,1595613,100.75,4550.36
567,5986.927625,193,1595806,100.60,4550.36
568,5940.674433,81,1595887,100.44,4550.36
569,6165.420384,200,1596087,100.42,4550.36
570,6120.249081,136,1596223,100.43,4550.36
571,6124.349107,134,1596357,100.27,4550.36
572,6061.427326,193,1596550,100.12,4550.36
573,6102.108761,191,1596741,99.96,4550.36
574,6195.283915,145,1596886,99.80,4550.36
575,6202.561710,118,1597004,99.64,4550.36
576,6340.279036,152,1597156,99.49,4550.36
577,6320.998979,133,1597289,99.47,4550.36
578,6444.344248,194,1597483,99.31,4550.36
579,6528.084224,192,1597675,99.15,4550.36
580,6702.984041,132,1597807,99.00,4550.36
581,6595.715156,82,1597889,98.85,4550.36
582,6667.479335,199,1598088,98.86,4550.36
583,6606.477004,137,1598225,98.71,4550.36
584,6612.563143,132,1598357,98.56,4550.36
585,6728.515809,192,1598549,98.40,4550.36
586,6848.158193,127,1598676,98.24,4550.36
587,6950.246297,145,1598821,98.08,4550.36
588,6830.573108,133,1598954,97.93,4550.36
589,6876.560591,138,1599092,97.93,4550.36
590,6812.564725,134,1599226,97.78,4550.36
591,6754.249106,133,1599359,97.62,4550.36
592,6779.426592,191,1599550,97.46,4484.83
593,6780.186552,190,1599740,97.31,4380.57
594,6838.568848,82,1599822,97.31,4309.32
595,6842.011856,132,1599954,97.17,4309.32
596,7006.282509,138,1600092,97.03,4309.32
597,6958.347757,136,1600228,96.88,4309.32
598,6999.980015,193,1600421,96.74,4309.32
599,6960.306100,132,1600553,96.59,4309.32
600,6959.808843,188,1600741,96.45,4309.32
601,6959.217533,81,1600822,96.43,4309.32
602,7018.841114,132,1600954,96.29,4309.32
603,6958.302427,119,1601073,96.29,4309.32
604,6975.517512,157,1601230,96.14,4309.32
605,7035.221511,191,1601421,96.00,4309.32
606,6955.327521,132,1601553,95.86,4309.32
607,6959.967329,189,1601742,95.87,4309.32
608,6834.478345,82,1601824,95.73,4309.49
609,6877.536314,180,1602004,95.59,4309.49
610,6923.993953,90,1602094,95.44,4309.49
611,6838.765156,136,1602230,95.30,4309.49
612,6716.534070,254,1602484,95.17,4309.49
613,6639.066506,134,1602618,95.03,4309.49
614,6635.456190,127,1602745,95.04,4309.49
615,6633.196521,143,1602888,95.03,4309.58
616,6682.299779,119,1603007,94.91,4309.58
617,6740.502193,150,1603157,94.80,4309.58
618,6791.570699,137,1603294,94.66,4309.58
619,6815.263751,256,1603550,94.66,4309.58
620,6731.857165,128,1603678,94.53,4309.58
621,6847.838439,134,1603812,94.40,4309.58
622,6814.949889,78,1603890,94.26,4309.58
623,6918.982152,119,1604009,94.13,4309.66
624,6908.592287,150,1604159,94.01,4309.66
625,7095.076090,135,1604294,94.06,4309.66
626,7078.736852,193,1604487,93.98,4309.66
627,7307.518212,116,1604603,93.90,4309.66
628,7350.224451,145,1604748,93.89,4309.66
629,7335.232301,139,1604887,93.86,4310.55
630,7276.860282,117,1605004,93.78,4335.97
631,7281.254950,72,1605076,93.83,4353.96
632,7343.964523,154,1605230,93.90,4353.96
633,7518.118034,131,1605361,93.79,4353.96
634,7490.696667,189,1605550,93.66,4353.96
635,7609.783367,131,1605681,93.52,4353.96
636,7527.966737,132,1605813,93.40,4353.96
637,7544.137624,78,1605891,93.26,4353.96
638,7605.618113,182,1606073,93.13,4353.96
639,7533.074471,88,1606161,93.00,4353.96
640,7542.929006,134,1606295,92.87,4353.96
641,7545.427239,191,1606486,92.88,4353.96
642,7586.588841,96,1606582,92.88,4353.96
643,7646.024933,164,1606746,92.75,4353.96
644,7614.159040,141,1606887,92.76,4353.96
645,7550.035223,118,1607005,92.64,4353.96
646,7553.804686,71,1607076,92.51,4353.96
647,7543.241859,154,1607230,92.38,4353.96
648,7542.523371,132,1607362,92.25,4354.05
649,7634.345811,189,1607551,92.12,4354.05
650,7608.109741,70,1607621,91.99,4354.05
651,7520.811452,191,1607812,91.87,4354.05
652,7538.477998,78,1607890,91.74,4354.05
653,7554.315215,119,1608009,91.74,4354.05
654,7550.606306,137,1608146,91.66,4354.05
655,7641.954280,90,1608236,91.62,4356.89
656,7556.769491,191,1608427,91.52,4356.89
657,7614.744205,127,1608554,91.49,4356.89
658,7555.379059,190,1608744,91.36,4356.89
659,7602.870442,81,1608825,91.25,4356.89
660,7540.310094,131,1608956,91.14,4356.89
661,7539.542269,120,1609076,91.01,4356.89
662,7583.998161,152,1609228,90.89,4356.89
663,7539.792166,132,1609360,90.76,4356.89
664,7524.779409,131,1609491,90.64,4356.89
665,7604.265750,130,1609621,90.48,4356.89
666,7583.565462,129,1609750,90.50,4356.89
667,7586.554843,142,1609892,90.38,4356.89
668,7526.024555,117,1610009,90.25,4356.89
669,7584.949915,137,1610146,90.25,4356.89
670,7547.413113,86,1610232,90.15,4356.89
671,7667.573704,195,1610427,90.04,4356.89
672,7783.045791,68,1610495,89.96,4356.89
673,7843.228457,127,1610622,89.88,4356.89
674,7780.600718,192,1610814,89.81,4356.89
675,7815.719431,79,1610893,89.70,4356.89
676,7899.004476,180,1611073,89.63,4356.89
677,7890.648119,73,1611146,89.69,4359.00
678,7909.596382,86,1611232,89.74,4359.00
679,7879.899440,197,1611429,89.68,4359.00
680,7869.959709,125,1611554,89.61,4359.00
681,7929.027468,69,1611623,89.49,4359.09
682,7955.108129,191,1611814,89.38,4359.09
683,7950.501856,78,1611892,89.26,4359.09
684,8007.743180,183,1612075,89.14,4359.09
685,7863.107469,88,1612163,89.03,4359.14
686,7936.998781,69,1612232,89.05,4359.14
687,7995.022845,197,1612429,88.94,4359.14
688,7945.230630,125,1612554,88.95,4359.14
689,7841.392132,135,1612689,88.85,4359.14
690,7994.583517,125,1612814,88.74,4359.14
691,7924.080082,79,1612893,88.75,4359.14
692,7922.881602,182,1613075,88.63,4359.14
693,7811.082493,88,1613163,88.52,4359.14
694,7818.157454,133,1613296,88.41,4359.14
695,7820.663078,191,1613487,88.29,4359.14
696,7789.431225,72,1613559,88.18,4359.14
697,7784.368431,186,1613745,88.07,4359.14
698,7864.093996,74,1613819,88.08,4359.14
699,7736.497020,138,1613957,87.99,4359.14
700,7780.251770,120,1614077,87.91,4359.14
701,7806.654919,151,1614228,87.93,4359.14
702,7751.707684,8,1614236,87.82,4359.14
703,0.000000,0,1614236,87.76,4359.14
704,0.000000,0,1614236,87.71,4361.45
705,9172.608067,388,1614624,87.59,4361.45
706,0.000000,0,1614624,87.48,4361.45
707,0.000000,0,1614624,87.37,4361.45
708,9284.537558,453,1615077,87.25,4361.45
709,0.000000,0,1615077,87.13,4361.45
710,7675.435388,289,1615366,87.02,4361.45
711,0.000000,0,1615366,86.91,4361.45
712,0.000000,0,1615366,86.81,4361.45
713,0.000000,0,1615366,86.70,4361.45
714,0.000000,0,1615366,86.58,4361.45
715,0.000000,0,1615366,86.47,4361.45
716,0.000000,0,1615366,86.35,4361.45
717,0.000000,0,1615366,86.24,4361.45
718,0.000000,0,1615366,86.12,4361.45
719,14299.705185,195,1615561,86.01,4361.45
720,0.000000,0,1615561,85.90,4361.45
721,0.000000,0,1615561,85.79,4361.45
722,0.000000,0,1615561,85.67,4361.45
723,0.000000,0,1615561,85.59,4361.45
724,0.000000,0,1615561,85.56,4361.45
725,0.000000,0,1615561,85.45,4361.45
726,17718.757903,649,1616210,85.34,4361.45
727,8395.538215,519,1616729,85.25,4361.45
728,1928.061624,390,1617119,85.28,4361.45
729,2263.459489,714,1617833,85.18,4361.45
730,1696.217533,454,1618287,85.10,4361.45
731,1750.396236,390,1618677,85.00,4361.45
732,2277.011356,650,1619327,84.96,4361.54
733,1985.344642,389,1619716,85.07,4363.69
734,1694.445475,520,1620236,85.03,4363.69
735,1983.611474,585,1620821,85.00,4363.69
736,2086.911489,520,1621341,84.91,4363.69
737,1920.747066,390,1621731,84.82,4363.69
738,1947.586757,455,1622186,84.74,4363.69
739,2048.509388,520,1622706,84.81,4363.69
740,1931.044286,584,1623290,84.87,4363.69
741,2670.447646,196,1623486,84.82,4363.69
742,2873.598268,260,1623746,84.77,4362.30
743,3369.403994,260,1624006,84.71,4362.30
744,3708.621597,324,1624330,84.77,4360.13
745,3569.098963,196,1624526,84.73,4360.13
746,3766.122895,323,1624849,84.78,4362.21
747,3713.690374,157,1625006,84.74,4362.21
748,3969.340100,259,1625265,84.65,4362.38
749,4108.176888,261,1625526,84.56,4362.38
750,4170.299405,260,1625786,84.46,4362.38
751,4164.413230,222,1626008,84.39,4362.38
752,4170.980562,258,1626266,84.38,4362.38
753,4158.082384,196,1626462,84.28,4362.38
754,4159.176322,195,1626657,84.19,4362.38
755,4237.201487,259,1626916,84.09,4362.38
756,4397.913811,234,1627150,84.02,4362.38
757,4377.866080,248,1627398,84.13,4362.38
758,4360.269728,258,1627656,84.04,4362.38
759,4419.133076,195,1627851,83.94,4362.38
760,4524.130216,159,1628010,83.84,4362.38
761,4585.713392,257,1628267,83.75,4362.38
762,4536.053974,260,1628527,83.65,4362.38
763,4544.365131,131,1628658,83.55,4362.38
764,4655.867560,260,1628918,83.58,4362.38
765,4702.713157,155,1629073,83.49,4362.38
766,4758.837914,260,1629333,83.39,4362.38
767,4903.519109,194,1629527,83.30,4362.38
768,4934.837459,134,1629661,83.20,4362.38
769,4990.791161,256,1629917,83.31,4362.38
770,5914.620358,1,1629918,83.25,4362.38
771,6683.839661,3,1629921,83.14,4362.38
772,6765.113340,217,1630138,83.05,4362.38
773,6765.539417,196,1630334,82.95,4362.38
774,6780.386920,194,1630528,82.85,4362.38
775,6942.826936,133,1630661,82.76,4362.38
776,6899.781108,257,1630918,82.74,4362.38
777,5307.347387,93,1631011,82.67,4362.38
778,5799.068890,128,1631139,82.57,4362.38
779,6059.502599,131,1631270,82.48,4362.38
780,6499.201665,130,1631400,82.38,4362.38
781,6906.928393,129,1631529,82.28,4362.38
782,7117.334194,132,1631661,82.30,4362.47
783,7179.400135,254,1631915,82.22,4362.47
784,7190.963893,71,1631986,82.14,4362.47
785,7235.967996,152,1632138,82.04,4362.47
786,7187.327262,132,1632270,81.95,4362.47
787,7186.561882,130,1632400,81.86,4362.47
788,7201.044573,128,1632528,81.76,4362.47
789,7153.866085,130,1632658,81.76,4362.47
790,7251.697369,194,1632852,81.67,4362.47
791,7140.012391,134,1632986,81.58,4362.47
792,7088.767831,88,1633074,81.48,4362.47
793,7095.630044,192,1633266,81.39,4362.47
794,7101.779585,71,1633337,81.30,4362.47
795,7104.709512,190,1633527,81.32,4362.47
796,7155.206411,131,1633658,81.23,4362.47
797,7083.952478,194,1633852,81.14,4362.47
798,7083.226186,135,1633987,81.06,4362.47
799,7082.220662,88,1634075,80.97,4362.47
800,7135.549351,128,1634203,80.88,4362.47
801,7149.142843,133,1634336,80.81,4362.55
802,7125.506175,128,1634464,80.85,4362.64
803,7073.271036,133,1634597,80.85,4362.64
804,7136.768832,255,1634852,80.76,4362.64
805,7131.489188,134,1634986,80.68,4362.64
806,6953.530490,88,1635074,80.58,4362.64
807,6988.120346,193,1635267,80.52,4362.64
808,6943.497699,71,1635338,80.52,4362.64
809,7011.957538,126,1635464,80.43,4362.64
810,7068.199419,134,1635598,80.34,4362.64
811,6953.512868,196,1635794,80.26,4362.64
812,7145.354276,129,1635923,80.17,4362.64
813,7229.081593,96,1636019,80.08,4362.64
814,7258.191096,128,1636147,80.10,4362.64
815,7283.067196,188,1636335,80.13,4362.64
816,7300.340684,72,1636407,80.04,4362.73
817,7200.434806,183,1636590,79.95,4362.73
818,7209.359494,141,1636731,79.86,4362.73
819,7246.557239,193,1636924,79.78,4362.73
820,7165.492961,95,1637019,79.79,4362.73
821,7146.678755,128,1637147,79.71,4362.73
822,7319.900178,186,1637333,79.63,4362.73
823,7196.637377,70,1637403,79.54,4362.73
824,7189.469204,131,1637534,79.46,4362.73
825,7255.985301,130,1637664,79.38,4362.73
826,7225.493227,254,1637918,79.29,4362.73
827,7181.329277,98,1638016,79.32,4363.41
828,7179.344816,130,1638146,79.34,4364.35
829,7182.755276,127,1638273,79.25,4364.35
830,7183.657311,129,1638402,79.17,4364.35
831,7185.918196,130,1638532,79.09,4364.35
832,7175.580900,132,1638664,79.00,4364.35
833,7292.391695,191,1638855,79.03,4364.35
834,7276.329760,158,1639013,78.95,4364.35
835,7237.638435,127,1639140,78.89,4364.35
836,7174.159960,66,1639206,78.86,4364.35
837,7334.275420,133,1639339,78.89,4364.35
838,7293.758683,128,1639467,78.88,4364.35
839,7335.176374,192,1639659,78.84,4364.35
840,7332.441288,136,1639795,78.79,4364.35
841,7347.203039,132,1639927,78.85,4364.35
842,7339.845943,148,1640075,78.81,4364.35
843,7283.853979,130,1640205,78.77,4364.35
844,7368.111165,128,1640333,78.83,4367.07
845,7507.512190,72,1640405,78.76,4367.07
846,7458.524411,130,1640535,78.79,4367.07
847,7462.140763,130,1640665,78.71,4367.07
848,7582.162812,132,1640797,78.62,4367.07
849,7725.772090,216,1641013,78.54,4367.16
850,7717.439090,127,1641140,78.46,4367.16
851,7663.423140,67,1641207,78.38,4367.16
852,7658.553566,132,1641339,78.30,4367.16
853,7651.792950,128,1641467,78.21,4367.16
854,7716.175107,132,1641599,78.23,4368.19
855,7666.567076,122,1641721,78.15,4368.19
856,7784.028630,135,1641856,78.18,4368.19
857,7790.465460,160,1642016,78.10,4368.19
858,7871.433967,131,1642147,78.04,4368.19
859,7792.195009,124,1642271,78.05,4368.28
860,7796.051256,73,1642344,77.96,4368.28
861,7830.090862,186,1642530,77.88,4368.28
862,7848.780009,131,1642661,77.80,4368.28
863,7793.866961,62,1642723,77.72,4368.28
864,7924.792369,198,1642921,77.64,4368.28
865,8047.567220,93,1643014,77.57,4368.28
866,8023.387566,133,1643147,77.49,4368.28
867,8041.697538,58,1643205,77.50,4370.34
868,8953.928094,66,1643271,77.42,4370.34
869,8954.758099,73,1643344,77.34,4370.34
870,8991.712919,125,1643469,77.26,4370.34
871,9058.247653,192,1643661,77.23,4370.34
872,9123.971020,61,1643722,77.21,4370.34
873,9090.858393,134,1643856,77.13,4370.34
874,9076.408174,157,1644013,77.05,4370.34
875,9085.172514,124,1644137,76.99,4370.34
876,9009.188773,71,1644208,76.95,4370.34
877,8413.788632,129,1644337,76.99,4370.34
878,8717.556320,67,1644404,76.96,4370.43
879,9006.561132,16,1644420,76.92,4370.43
880,9059.608409,241,1644661,76.87,4370.43
881,9050.286613,61,1644722,76.83,4370.43
882,9134.610489,152,1644874,76.79,4370.43
883,9048.300464,122,1644996,76.75,4382.21
884,9372.515105,26,1645022,76.92,4383.44
885,9409.894265,183,1645205,76.90,4383.44
886,9514.191120,68,1645273,76.83,4383.44
887,9496.871169,70,1645343,76.74,4383.44
888,9395.355389,69,1645412,76.67,4383.44
889,9589.677786,122,1645534,76.59,4383.44
890,9755.760844,128,1645662,76.51,4383.44
891,9770.960748,64,1645726,76.43,4383.53
892,9897.084207,137,1645863,76.36,4383.06
893,9974.305500,134,1645997,76.28,4383.15
894,9898.254621,90,1646087,76.20,4382.83
895,9890.317182,119,1646206,76.13,4382.92
896,9889.390853,70,1646276,76.15,4384.04
897,9896.600451,68,1646344,76.17,4384.04
898,10005.962611,68,1646412,76.10,4384.04
899,10006.836811,119,1646531,76.05,4384.04
900,9995.933156,133,1646664,76.01,4384.04
901,10007.065154,62,1646726,75.97,4384.04
902,10053.196615,138,1646864,75.93,4384.04
903,9996.603301,133,1646997,76.00,4384.04
904,10002.881490,26,1647023,75.97,4394.68
905,10150.538532,182,1647205,76.02,4397.32
906,10096.772129,6,1647211,75.99,4397.32
907,10957.333731,2,1647213,75.96,4397.32
908,11289.025797,128,1647341,75.91,4397.32
909,11321.116466,68,1647409,75.84,4397.32
910,11445.159153,14,1647423,75.74,4397.32
911,11390.665401,117,1647540,75.67,4397.32
912,11405.863501,130,1647670,75.59,4397.32
913,11295.469761,128,1647798,75.51,4397.32
914,11422.082241,132,1647930,75.54,4397.32
915,11322.118018,89,1648019,75.48,4397.32
916,11278.536155,132,1648151,75.42,4397.32
917,11336.007901,61,1648212,75.44,4403.60
918,10439.089108,66,1648278,75.37,4403.60
919,10713.975850,66,1648344,75.29,4403.60
920,10964.034397,62,1648406,75.21,4403.60
921,11058.906279,15,1648421,75.14,4403.60
922,11189.258844,119,1648540,75.06,4403.60
923,11110.680429,128,1648668,74.99,4403.60
924,11228.785939,126,1648794,74.91,4403.60
925,11017.020649,136,1648930,74.84,4403.60
926,11188.287851,90,1649020,74.76,4403.60
927,11155.095226,122,1649142,74.79,4406.53
928,11210.745257,67,1649209,74.72,4406.53
929,11065.337663,67,1649276,74.72,4406.53
930,0.000000,0,1649276,74.76,4406.53
931,0.000000,0,1649276,74.70,4406.53
932,12788.784580,145,1649421,74.64,4406.53
933,0.000000,0,1649421,74.57,4406.53
934,0.000000,0,1649421,74.50,4406.53
935,0.000000,0,1649421,74.42,4406.53
936,0.000000,0,1649421,74.35,4406.53
937,13310.733742,576,1649997,74.27,4406.53
938,0.000000,0,1649997,74.20,4406.53
939,0.000000,0,1649997,74.13,4406.53
940,13826.478162,59,1650056,74.06,4406.53
941,11506.013431,286,1650342,73.99,4406.53
942,0.000000,0,1650342,73.92,4406.53
943,0.000000,0,1650342,73.94,4406.53
944,0.000000,0,1650342,73.87,4406.53
945,0.000000,0,1650342,73.88,4406.53
946,0.000000,0,1650342,73.82,4406.53
947,12896.413506,131,1650473,73.73,4406.53
948,0.000000,0,1650473,73.66,4406.53
949,0.000000,0,1650473,73.59,4406.53
950,0.000000,0,1650473,73.51,4406.53
951,0.000000,0,1650473,73.44,4406.53
952,0.000000,0,1650473,73.36,4406.53
953,16151.146602,520,1650993,73.30,4406.53
954,12002.070234,454,1651447,73.24,4406.53
955,2122.898243,520,1651967,73.18,4406.53
956,2124.913534,455,1652422,73.12,4406.53
957,1985.196255,519,1652941,73.07,4406.53
958,1957.084088,463,1653404,73.01,4406.53
959,1968.530183,511,1653915,73.04,4406.53
960,1900.090228,519,1654434,73.09,4406.53
961,2051.153980,519,1654953,73.04,4406.53
962,2027.214920,520,1655473,73.07,4406.53
963,2069.665020,520,1655993,73.00,4406.53
964,1970.155296,520,1656513,72.95,4406.53
965,1679.080358,130,1656643,72.89,4406.53
966,2622.988359,364,1657007,72.82,4406.53
967,3262.626417,221,1657228,72.84,4406.53
968,3596.210738,260,1657488,72.89,4406.53
969,3841.378730,324,1657812,72.82,4406.62
970,3920.126319,259,1658071,72.76,4406.62
971,3818.154218,196,1658267,72.69,4406.62
972,3998.289021,221,1658488,72.63,4406.62
973,3986.738422,260,1658748,72.56,4406.62
974,3986.153979,323,1659071,72.60,4406.62
975,3952.888404,198,1659269,72.54,4406.62
976,3951.029875,220,1659489,72.47,4406.62
977,4102.372731,259,1659748,72.41,4406.62
978,4272.558631,194,1659942,72.34,4406.62
979,4355.509027,260,1660202,72.29,4406.62
980,4404.700769,157,1660359,72.32,4406.62
981,4544.846154,262,1660621,72.35,4406.62
982,4575.982485,194,1660815,72.29,4406.62
983,4644.686093,258,1661073,72.23,4406.62
984,4665.704992,194,1661267,72.17,4406.88
985,4600.183227,159,1661426,72.11,4406.88
986,4669.129311,262,1661688,72.04,4406.88
987,4641.420242,254,1661942,72.08,4406.88
988,4583.904974,132,1662074,72.02,4406.88
989,4801.780828,258,1662332,71.96,4406.88
990,4833.393116,160,1662492,71.90,4406.88
991,4922.795517,197,1662689,71.83,4406.88
992,4960.227994,194,1662883,71.77,4406.88
993,5248.496535,191,1663074,71.85,4406.88
994,5125.348504,195,1663269,71.83,4406.88
995,5185.014058,158,1663427,71.77,4406.88
996,5171.835655,199,1663626,71.70,4406.88
997,5286.350065,194,1663820,71.64,4406.88
998,5271.132928,253,1664073,71.58,4406.88
999,5258.920327,135,1664208,71.56,4406.88
1000,5244.067360,218,1664426,71.56,4406.88
1001,5269.295287,135,1664561,71.50,4406.88
1002,5215.175992,254,1664815,71.43,4406.88
1003,5214.738996,132,1664947,71.39,4406.88
1004,5291.306432,257,1665204,71.45,4406.88
1005,5208.468216,158,1665362,71.42,4406.88
1006,5243.811652,199,1665561,71.48,4406.88
1007,5260.936825,252,1665813,71.46,4406.88
1008,5194.989852,73,1665886,71.45,4406.88
1009,5251.161910,189,1666075,71.42,4406.88
1010,5374.115894,194,1666269,71.39,4406.88
1011,5366.777625,224,1666493,71.46,4411.98
1012,5389.541246,135,1666628,71.49,4411.98
1013,5490.886303,193,1666821,71.48,4411.98
1014,5450.286351,232,1667053,71.41,4411.98
1015,5592.175558,151,1667204,71.35,4411.98
1016,5589.864600,158,1667362,71.29,4411.98
1017,5775.886538,196,1667558,71.23,4411.98
1018,5762.105137,131,1667689,71.17,4411.98
1019,5697.908135,198,1667887,71.11,4412.07
1020,5728.173730,186,1668073,71.14,4412.07
1021,5822.636360,136,1668209,71.08,4412.07
1022,5829.334758,158,1668367,71.11,4412.16
1023,5864.950727,194,1668561,71.05,4412.16
1024,5884.245779,252,1668813,70.99,4412.16
1025,5827.131457,76,1668889,71.01,4412.25
1026,5926.621832,187,1669076,70.96,4412.25
1027,5818.802789,136,1669212,70.90,4412.25
1028,5879.462336,156,1669368,70.84,4412.25
1029,5871.348257,195,1669563,70.78,4412.25
1030,5833.833623,193,1669756,70.72,4412.25
1031,6071.518211,133,1669889,70.66,4412.25
1032,6064.731774,184,1670073,70.60,4412.25
1033,6141.995120,139,1670212,70.63,4412.25
1034,6170.025286,156,1670368,70.57,4412.25
1035,6189.980549,63,1670431,70.60,4413.46
1036,0.000000,0,1670431,70.54,4413.46
1037,7922.328278,135,1670566,70.47,4413.46
1038,7927.049041,237,1670803,70.41,4413.46
1039,7914.273525,86,1670889,70.44,4413.46
1040,7992.329538,186,1671075,70.38,4413.46
1041,8004.263655,137,1671212,70.32,4413.46
1042,8025.498354,156,1671368,70.26,4413.20
1043,7236.773804,131,1671499,70.20,4413.19
1044,6723.266720,66,1671565,70.14,4413.19
1045,7158.850688,126,1671691,70.11,4413.19
1046,7467.616995,129,1671820,70.10,4413.19
1047,7743.318007,72,1671892,70.04,4413.19
1048,7844.466374,185,1672077,69.99,4413.19
1049,7887.784071,141,1672218,69.94,4413.19
1050,7925.082318,151,1672369,69.88,4413.19
1051,7818.908022,130,1672499,69.88,4413.19
1052,7815.033742,68,1672567,69.85,4413.19
1053,7870.187672,125,1672692,69.79,4413.19
1054,7918.470661,132,1672824,69.73,4413.19
1055,7855.070394,128,1672952,69.67,4413.19
1056,7982.662560,125,1673077,69.62,4413.19
1057,7923.528141,139,1673216,69.56,4413.19
1058,7998.247319,154,1673370,69.57,4414.05
1059,7969.263030,131,1673501,69.52,4414.05
1060,7969.251142,127,1673628,69.46,4414.05
1061,7911.289778,129,1673757,69.40,4414.05
1062,7798.168097,71,1673828,69.35,4414.05
1063,7867.615677,125,1673953,69.29,4414.05
1064,7829.386674,126,1674079,69.31,4414.05
1065,7875.334487,153,1674232,69.27,4414.05
1066,7991.026412,139,1674371,69.22,4414.05
1067,7951.416586,131,1674502,69.16,4414.05
1068,8001.962596,126,1674628,69.11,4414.05
1069,8000.143991,128,1674756,69.13,4414.05
1070,7937.701551,71,1674827,69.08,4414.05
1071,7924.721296,128,1674955,69.10,4416.12
1072,7957.569957,124,1675079,69.05,4416.12
1073,8092.993440,144,1675223,69.00,4416.12
1074,8130.003160,148,1675371,68.94,4416.12
1075,8015.663199,131,1675502,68.89,4416.12
1076,8021.156555,127,1675629,68.83,4416.12
1077,8047.276876,127,1675756,68.85,4416.12
1078,8144.422757,71,1675827,68.81,4416.12
1079,8039.992771,126,1675953,68.75,4416.12
1080,8045.010633,125,1676078,68.70,4416.12
1081,8094.851534,142,1676220,68.64,4416.12
1082,8278.492796,122,1676342,68.67,4418.93
1083,8305.995299,99,1676441,68.62,4418.93
1084,8480.701920,128,1676569,68.65,4418.93
1085,8412.898471,67,1676636,68.59,4418.93
1086,8364.034559,187,1676823,68.53,4418.93
1087,8295.843618,72,1676895,68.48,4418.93
1088,8297.555490,162,1677057,68.43,4418.93
1089,8300.911589,155,1677212,68.37,4418.93
1090,8293.131820,65,1677277,68.38,4418.93
1091,8315.042581,161,1677438,68.35,4418.93
1092,8400.870974,68,1677506,68.29,4418.93
1093,8345.346391,125,1677631,68.24,4418.93
1094,8347.551226,129,1677760,68.18,4418.93
1095,8295.335215,130,1677890,68.21,4420.38
1096,8293.782527,130,1678020,68.17,4420.38
1097,8331.681773,126,1678146,68.19,4423.53
1098,8372.949609,89,1678235,68.14,4423.53
1099,8183.272123,140,1678375,68.08,4423.53
1100,8180.147196,128,1678503,68.03,4423.53
1101,8277.358988,72,1678575,67.98,4423.53
1102,8255.975950,185,1678760,67.95,4423.53
1103,8240.102328,129,1678889,67.98,4423.53
1104,8190.233277,129,1679018,67.99,4423.53
1105,8196.603586,62,1679080,67.97,4423.53
1106,8239.825338,141,1679221,68.03,4423.53
1107,8344.951379,150,1679371,68.01,4423.53
1108,8301.357002,130,1679501,68.06,4423.53
1109,8302.133307,70,1679571,68.04,4423.53
1110,8236.479464,131,1679702,68.02,4423.53
1111,8299.950505,126,1679828,67.99,4423.70
1112,8293.711475,70,1679898,67.94,4423.70
1113,8424.063139,160,1680058,67.88,4423.70
1114,8449.452438,91,1680149,67.92,4423.70
1115,8543.342864,87,1680236,67.86,4423.70
1116,8576.284682,154,1680390,67.83,4423.70
1117,8653.936452,116,1680506,67.84,4423.97
1118,8534.405070,71,1680577,67.79,4423.97
1119,8571.233815,184,1680761,67.73,4423.97
1120,8527.421589,128,1680889,67.68,4423.97
1121,8581.055058,128,1681017,67.69,4423.97
1122,8637.491758,63,1681080,67.68,4423.97
1123,8704.780429,135,1681215,67.65,4423.97
1124,8761.253250,24,1681239,67.63,4424.05
1125,8936.646040,199,1681438,67.61,4424.05
1126,8896.544688,69,1681507,67.67,4424.05
1127,8882.848612,71,1681578,67.72,4432.46
1128,8916.545623,183,1681761,67.70,4432.46
1129,8930.633354,132,1681893,67.68,4432.46
1130,8937.801778,124,1682017,67.65,4432.46
1131,9038.533009,63,1682080,67.63,4432.46
1132,9013.924813,136,1682216,67.57,4432.54
1133,8991.190999,21,1682237,67.52,4432.90
1134,9884.100330,2,1682239,67.55,4432.90
1135,0.000000,0,1682239,67.58,4432.90
1136,11756.955408,1,1682240,67.53,4432.90
1137,11890.555097,202,1682442,67.47,4432.90
1138,11893.885119,126,1682568,67.42,4432.90
1139,11915.475530,69,1682637,67.36,4432.90
1140,11925.901349,185,1682822,67.31,4432.90
1141,11932.948787,74,1682896,67.26,4432.90
1142,12029.521810,121,1683017,67.21,4432.90
1143,12063.947759,63,1683080,67.16,4433.16
1144,11999.816942,135,1683215,67.10,4433.16
1145,12021.676487,23,1683238,67.04,4433.16
1146,9548.918851,131,1683369,67.00,4433.16
1147,9566.248129,133,1683502,67.05,4433.16
1148,9389.166950,75,1683577,67.02,4433.16
1149,9443.056830,127,1683704,67.03,4433.16
1150,9705.098306,121,1683825,67.00,4433.16
1151,10019.952687,66,1683891,66.98,4433.16
1152,10296.038265,8,1683899,66.95,4433.16
1153,10888.778920,120,1684019,66.93,4433.16
1154,0.000000,0,1684019,66.91,4433.16
1155,0.000000,0,1684019,66.96,4441.07
1156,11703.054062,205,1684224,66.97,4441.60
1157,0.000000,0,1684224,66.95,4441.60
1158,0.000000,0,1684224,66.92,4441.60
1159,0.000000,0,1684224,66.86,4441.60
1160,0.000000,0,1684224,66.81,4441.60
1161,0.000000,0,1684224,66.76,4441.60
1162,13745.507500,669,1684893,66.71,4441.60
1163,0.000000,0,1684893,66.75,4441.69
1164,0.000000,0,1684893,66.70,4441.69
1165,11808.771706,138,1685031,66.64,4441.69
1166,0.000000,0,1685031,66.59,4441.69
1167,0.000000,0,1685031,66.54,4441.69
1168,12687.138448,65,1685096,66.48,4441.69
1169,0.000000,0,1685096,66.43,4441.69
1170,0.000000,0,1685096,66.37,4441.69
1171,0.000000,0,1685096,66.32,4441.69
1172,0.000000,0,1685096,66.26,4441.69
1173,0.000000,0,1685096,66.21,4441.69
1174,18246.723810,130,1685226,66.15,4441.69
1175,0.000000,0,1685226,66.11,4441.69
1176,14487.111256,237,1685463,66.05,4441.69
1177,14926.897480,478,1685941,66.09,4441.69
1178,12458.944325,65,1686006,66.05,4441.69
1179,3155.361602,974,1686980,66.06,4441.69
1180,1419.205519,390,1687370,66.05,4441.69
1181,2345.932911,649,1688019,66.00,4441.69
1182,2037.511436,325,1688344,65.97,4441.78
1183,1525.218481,391,1688735,65.99,4441.78
1184,2573.553112,260,1688995,65.94,4441.78
1185,3093.554224,260,1689255,65.89,4441.78
1186,3488.987677,260,1689515,65.84,4441.78
1187,3899.376773,259,1689774,65.79,4441.78
1188,3967.442521,195,1689969,65.81,4441.78
1189,4017.184938,286,1690255,65.77,4441.78
1190,3912.503950,260,1690515,65.72,4441.78
1191,4064.760424,259,1690774,65.68,4441.78
1192,4026.768068,260,1691034,65.63,4441.22
1193,4039.108876,221,1691255,65.59,4440.96
1194,4086.703026,258,1691513,65.54,4417.44
1195,4304.956505,196,1691709,65.52,4417.80
1196,4210.918808,197,1691906,65.53,4417.80
1197,4300.933539,261,1692167,65.49,4417.80
1198,4358.329037,218,1692385,65.44,4417.80
1199,4445.958402,196,1692581,65.40,4417.80
1200,4673.767456,195,1692776,65.36,4417.80
1201,4641.063909,258,1693034,65.43,4417.80
1202,4768.249954,198,1693232,65.41,4417.80
1203,4837.570595,216,1693448,65.36,4417.80
1204,4864.500671,134,1693582,65.32,4417.80
1205,4873.723080,258,1693840,65.27,4417.88
1206,4969.224502,194,1694034,65.22,4417.88
1207,5009.981506,198,1694232,65.18,4417.88
1208,5010.230491,216,1694448,65.13,4417.88
1209,5085.322500,134,1694582,65.16,4417.88
1210,5124.029987,193,1694775,65.12,4417.88
1211,5150.314666,133,1694908,65.08,4417.88
1212,5201.645960,293,1695201,65.03,4417.88
1213,5123.333825,184,1695385,65.06,4417.88
1214,5095.104827,135,1695520,65.09,4417.88
1215,5125.041586,195,1695715,65.05,4417.88
1216,5092.117339,193,1695908,65.00,4417.88
1217,5215.460898,194,1696102,64.96,4417.88
1218,5497.862389,195,1696297,64.91,4417.88
1219,5589.041884,217,1696514,64.87,4417.88
1220,5592.409840,133,1696647,64.82,4417.88
1221,5684.043544,193,1696840,64.78,4417.88
1222,5593.365462,134,1696974,64.81,4417.88
1223,5597.986517,193,1697167,64.77,4417.88
1224,5598.459178,180,1697347,64.72,4417.88
1225,5676.832411,171,1697518,64.68,4418.22
1226,5595.561679,135,1697653,64.71,4418.22
1227,5655.243785,253,1697906,64.74,4418.22
1228,5596.436058,129,1698035,64.70,4418.22
1229,5634.577634,197,1698232,64.66,4418.48
1230,5594.147317,180,1698412,64.62,4418.48
1231,5757.941155,112,1698524,64.57,4418.48
1232,5758.304045,193,1698717,64.53,4418.48
1233,5719.561145,193,1698910,64.48,4418.48
1234,5726.523390,193,1699103,64.44,4418.48
1235,5724.776071,194,1699297,64.47,4418.51
1236,5717.693969,154,1699451,64.42,4418.51
1237,5708.219411,197,1699648,64.38,4418.51
1238,5640.447365,133,1699781,64.33,4418.60
1239,5657.134381,194,1699975,64.35,4418.60
1240,5655.348098,195,1700170,64.40,4418.60
1241,5655.973961,178,1700348,64.35,4418.60
1242,5614.848514,170,1700518,64.31,4418.60
1243,5752.634488,136,1700654,64.27,4418.60
1244,5810.304430,252,1700906,64.22,4418.60
1245,5942.242228,70,1700976,64.18,4418.60
1246,5898.252217,194,1701170,64.13,4418.60
1247,5980.890368,178,1701348,64.09,4418.60
1248,6038.081022,170,1701518,64.13,4418.60
1249,5997.749534,133,1701651,64.08,4418.60
1250,5903.662850,199,1701850,64.05,4418.60
1251,5915.396380,188,1702038,64.04,4418.60
1252,5957.059235,134,1702172,64.16,4418.60
1253,5830.982330,241,1702413,64.15,4418.60
1254,5857.369372,111,1702524,64.14,4418.60
1255,5817.843535,132,1702656,64.12,4418.60
1256,5977.158818,195,1702851,64.10,4418.60
1257,5956.795475,187,1703038,64.08,4440.16
1258,5942.296978,132,1703170,64.13,4456.52
1259,6141.940569,152,1703322,64.13,4456.52
1260,6315.489576,132,1703454,64.08,4456.52
1261,6287.632141,197,1703651,64.11,4456.52
1262,6305.181990,136,1703787,64.07,4456.52
1263,6186.600386,249,1704036,64.03,4456.52
1264,6182.861297,134,1704170,63.98,4456.52
1265,6354.877167,151,1704321,64.01,4456.52
1266,6385.900507,95,1704416,63.97,4456.52
1267,6364.758910,172,1704588,63.93,4456.52
1268,6309.892774,136,1704724,63.89,4456.52
1269,6431.944389,189,1704913,63.84,4456.52
1270,6365.993919,191,1705104,63.87,4456.52
1271,6440.647604,72,1705176,63.83,4456.52
1272,6411.401851,176,1705352,63.78,4456.52
1273,6402.842491,174,1705526,63.75,4456.52
1274,6525.608599,131,1705657,63.77,4456.52
1275,6529.604166,132,1705789,63.73,4456.52
1276,6621.562520,250,1706039,63.69,4456.52
1277,6635.919265,131,1706170,63.65,4456.52
1278,6682.674563,130,1706300,63.64,4456.52
1279,6716.851641,115,1706415,63.63,4457.20
1280,6708.424539,112,1706527,63.59,4457.20
1281,6865.440145,17,1706544,63.55,4457.20
1282,7531.401880,45,1706589,63.50,4457.20
1283,9078.258135,65,1706654,63.46,4457.20
1284,9230.105092,133,1706787,63.41,4457.20
1285,9219.155493,131,1706918,63.37,4457.20
1286,9340.347558,187,1707105,63.33,4457.29
1287,9332.114296,84,1707189,63.30,4457.29
1288,9431.752175,163,1707352,63.31,4462.41
1289,9347.200697,169,1707521,63.27,4462.41
1290,9019.859857,68,1707589,63.22,4462.41
1291,7598.900260,68,1707657,63.18,4462.41
1292,7863.445595,130,1707787,63.21,4462.41
1293,8163.951278,123,1707910,63.17,4462.41
1294,8670.600122,73,1707983,63.13,4462.41
1295,8862.177226,122,1708105,63.09,4462.41
1296,9047.552171,84,1708189,63.04,4462.41
1297,9095.075602,139,1708328,62.99,4462.41
1298,9080.074675,192,1708520,62.95,4462.41
1299,9037.408611,26,1708546,62.91,4462.41
1300,9152.719238,111,1708657,62.87,4462.41
1301,9044.995663,130,1708787,62.89,4463.18
1302,9029.037285,70,1708857,62.85,4463.18
1303,9162.481777,126,1708983,62.80,4463.18
1304,9102.239699,122,1709105,62.76,4463.18
1305,9044.648168,84,1709189,62.79,4463.18
1306,9079.139273,139,1709328,62.82,4463.18
1307,9056.949058,129,1709457,62.78,4463.18
1308,9154.425248,90,1709547,62.74,4463.18
1309,9121.198390,110,1709657,62.70,4463.18
1310,9093.427920,130,1709787,62.65,4463.18
1311,9150.673048,71,1709858,62.61,4463.18
1312,9043.697768,59,1709917,62.57,4463.18
1313,9087.523948,188,1710105,62.53,4463.79
1314,9210.749444,84,1710189,62.56,4463.79
1315,9125.924416,139,1710328,62.52,4463.79
1316,9056.696083,120,1710448,62.48,4463.79
1317,9043.465734,96,1710544,62.44,4463.79
1318,9158.945990,108,1710652,62.47,4464.83
1319,9039.863624,75,1710727,62.50,4464.83
1320,9037.244375,128,1710855,62.46,4464.83
1321,9145.652697,61,1710916,62.42,4464.83
1322,9091.286366,181,1711097,62.38,4464.83
1323,8946.343761,78,1711175,62.33,4464.83
1324,9095.151620,128,1711303,62.30,4464.83
1325,9073.352513,117,1711420,62.25,4464.91
1326,9061.532178,127,1711547,62.22,4464.91
1327,9102.336246,105,1711652,62.19,4464.91
1328,9132.476276,75,1711727,62.21,4464.91
1329,9102.029342,128,1711855,62.16,4464.91
1330,9041.625698,62,1711917,62.15,4464.91
1331,9162.772786,180,1712097,62.19,4464.91
1332,9168.481684,77,1712174,62.25,4464.91
1333,9163.537027,129,1712303,62.24,4464.91
1334,9236.533178,116,1712419,62.23,4464.91
1335,9249.225126,111,1712530,62.27,4477.84
1336,9239.203298,72,1712602,62.27,4477.84
1337,9164.723693,125,1712727,62.25,4477.84
1338,9168.994756,128,1712855,62.24,4477.84
1339,9270.567272,60,1712915,62.21,4477.84
1340,9192.584432,71,1712986,62.17,4477.84
1341,9369.265393,185,1713171,62.13,4477.84
1342,9264.672868,23,1713194,62.09,4477.92
1343,9308.380240,222,1713416,62.05,4477.82
1344,9270.592299,108,1713524,62.03,4477.82
1345,9320.350625,68,1713592,62.13,4477.82
1346,9320.815848,74,1713666,62.15,4477.82
1347,9205.725073,127,1713793,62.10,4477.82
1348,9171.255287,122,1713915,62.07,4477.82
1349,9089.746543,73,1713988,62.02,4477.82
1350,9148.779674,119,1714107,61.99,4477.82
1351,9091.521498,85,1714192,61.94,4477.82
1352,9070.446839,225,1714417,61.91,4477.82
1353,8951.379596,107,1714524,61.86,4477.82
1354,8995.579450,70,1714594,61.83,4477.82
1355,9033.361129,72,1714666,61.79,4477.82
1356,8980.208793,131,1714797,61.75,4477.82
1357,8928.391485,118,1714915,61.71,4477.82
1358,8964.309564,74,1714989,61.80,4482.86
1359,8804.746712,183,1715172,61.83,4482.86
1360,8853.504695,21,1715193,61.79,4482.86
1361,9462.163085,162,1715355,61.75,4482.86
1362,0.000000,0,1715355,61.71,4482.86
1363,0.000000,0,1715355,61.67,4482.86
1364,0.000000,0,1715355,61.63,4482.86
1365,10624.643773,372,1715727,61.59,4482.86
1366,9899.605685,189,1715916,61.55,4482.86
1367,0.000000,0,1715916,61.52,4482.86
1368,0.000000,0,1715916,61.48,4482.86
1369,0.000000,0,1715916,61.45,4482.86
1370,0.000000,0,1715916,61.40,4482.86
1371,0.000000,0,1715916,61.36,4482.86
1372,12632.762402,450,1716366,61.39,4482.86
1373,7964.252658,110,1716476,61.34,4482.86
1374,0.000000,0,1716476,61.29,4482.86
1375,10166.627812,65,1716541,61.26,4482.86
1376,0.000000,0,1716541,61.23,4482.86
1377,12865.940847,65,1716606,61.19,4482.86
1378,0.000000,0,1716606,61.21,4482.86
1379,0.000000,0,1716606,61.16,4482.86
1380,0.000000,0,1716606,61.12,4482.86
1381,0.000000,0,1716606,61.08,4482.86
1382,0.000000,0,1716606,61.04,4482.86
1383,0.000000,0,1716606,60.99,4482.86
1384,18810.261434,129,1716735,60.95,4482.86
1385,18686.628904,130,1716865,60.91,4483.89
1386,14220.440764,455,1717320,60.88,4483.89
1387,11319.675317,324,1717644,60.85,4483.89
1388,2212.305796,715,1718359,60.81,4483.89
1389,1818.967277,584,1718943,60.79,4483.89
1390,1866.169686,453,1719396,60.75,4483.89
1391,1891.133604,650,1720046,60.77,4483.89
1392,2039.725168,390,1720436,60.84,4483.89
1393,1958.070971,585,1721021,60.83,4483.98
1394,1985.931757,520,1721541,60.89,4483.98
1395,2114.839287,455,1721996,60.89,4483.98
1396,2091.502245,540,1722536,60.91,4483.98
1397,1822.668298,305,1722841,60.94,4483.98
1398,1967.384055,649,1723490,61.00,4483.98
1399,2072.428155,585,1724075,61.00,4483.98
1400,2139.501978,259,1724334,60.99,4483.98
1401,2361.235429,260,1724594,60.99,4483.98
1402,3010.222826,261,1724855,61.03,4484.06
1403,3543.245853,259,1725114,61.00,4484.06
1404,3826.772015,260,1725374,60.96,4484.06
1405,3975.539448,261,1725635,60.93,4484.06
1406,3851.575036,195,1725830,60.89,4484.06
1407,4039.903810,285,1726115,60.92,4484.06
1408,3984.219793,260,1726375,60.89,4484.06
1409,4011.488998,260,1726635,60.85,4484.06
1410,3946.372321,257,1726892,60.82,4484.06
1411,4085.908348,159,1727051,60.84,4484.06
1412,4121.314523,318,1727369,60.81,4484.06
1413,4116.806866,201,1727570,60.78,4484.06
1414,4078.442426,260,1727830,60.81,4484.06
1415,4187.133613,192,1728022,60.78,4484.06
1416,4486.641336,159,1728181,60.74,4484.06
1417,4640.141472,260,1728441,60.71,4484.06
1418,4670.858931,260,1728701,60.67,4484.06
1419,4608.725931,220,1728921,60.64,4484.06
1420,4693.060775,131,1729052,60.66,4484.33
1421,4640.748361,257,1729309,60.63,4484.33
1422,4618.394097,197,1729506,60.60,4484.33
1423,4737.300435,259,1729765,60.56,4484.33
1424,0.000000,0,1729765,60.53,4484.33
1425,6069.375012,132,1729897,60.55,4484.33
1426,6194.099934,126,1730023,60.51,4484.33
1427,6297.970669,159,1730182,60.47,4484.68
1428,6482.431500,195,1730377,60.44,4484.68
1429,6568.455129,260,1730637,60.40,4484.68
1430,6103.287307,193,1730830,60.36,4484.74
1431,5614.461306,92,1730922,60.33,4484.74
1432,5931.535058,100,1731022,60.29,4484.74
1433,6106.590455,97,1731119,60.29,4484.74
1434,6348.739505,195,1731314,60.28,4484.74
1435,6370.276471,199,1731513,60.25,4484.74
1436,6477.953831,253,1731766,60.21,4484.74
1437,6542.716159,69,1731835,60.17,4484.74
1438,6462.936991,106,1731941,60.20,4484.74
1439,6490.504777,112,1732053,60.16,4484.74
1440,6574.142762,132,1732185,60.13,4484.74
1441,6496.757902,257,1732442,60.09,4484.74
1442,6338.842655,196,1732638,60.05,4484.74
1443,6419.044153,194,1732832,60.02,4484.74
1444,6328.039632,93,1732925,59.99,4484.74
1445,6422.346637,101,1733026,59.96,4484.74
1446,6322.067566,95,1733121,59.92,4484.74
1447,6509.116619,193,1733314,59.95,4484.74
1448,6448.865947,194,1733508,59.91,4484.74
1449,6633.836967,257,1733765,59.88,4484.74
1450,6792.883899,69,1733834,59.84,4484.74
1451,6672.232573,108,1733942,59.93,4484.74
1452,6588.683494,175,1734117,59.90,4484.74
1453,6590.376416,70,1734187,59.87,4484.74
1454,6632.057277,255,1734442,59.83,4484.74
1455,6686.308090,196,1734638,59.80,4484.74
1456,6574.733063,138,1734776,59.76,4484.74
1457,6627.962055,146,1734922,59.73,4484.74
1458,6478.349580,103,1735025,59.69,4484.74
1459,6451.069898,96,1735121,59.66,4484.74
1460,6568.586061,131,1735252,59.67,4484.74
1461,6462.492471,258,1735510,59.66,4484.74
1462,6566.633456,193,1735703,59.64,4484.74
1463,6583.315159,130,1735833,59.67,4484.74
1464,6593.116273,109,1735942,59.74,4484.74
1465,6621.370778,175,1736117,59.73,4484.74
1466,6555.440864,69,1736186,59.72,4484.74
1467,6462.139863,214,1736400,59.71,4484.74
1468,6836.208533,116,1736516,59.70,4484.74
1469,6850.298774,249,1736765,59.68,4484.74
1470,6797.955684,70,1736835,59.73,4488.17
1471,6843.365670,107,1736942,59.73,4488.17
1472,6857.672171,175,1737117,59.71,4488.17
1473,6941.132287,70,1737187,59.67,4488.17
1474,7003.879818,213,1737400,59.71,4488.17
1475,6946.513320,116,1737516,59.68,4488.17
1476,7054.769293,249,1737765,59.64,4488.17
1477,7156.976228,70,1737835,59.61,4488.17
1478,7096.519154,108,1737943,59.65,4493.30
1479,7187.662585,116,1738059,59.61,4493.30
1480,7125.728019,128,1738187,59.58,4493.30
1481,7048.824521,132,1738319,59.55,4493.30
1482,7238.097488,191,1738510,59.58,4493.30
1483,7303.837847,139,1738649,59.55,4493.30
1484,7475.797700,127,1738776,59.51,4493.30
1485,7666.442164,124,1738900,59.48,4493.30
1486,7543.645829,63,1738963,59.44,4493.30
1487,7556.350289,158,1739121,59.44,4493.81
1488,7601.272777,130,1739251,59.44,4494.33
1489,7543.650176,198,1739449,59.42,4494.33
1490,7715.086061,67,1739516,59.39,4494.33
1491,7664.594331,198,1739714,59.42,4494.33
1492,7780.038047,66,1739780,59.39,4494.33
1493,7905.755913,121,1739901,59.35,4463.55
1494,7802.612458,41,1739942,59.32,4463.55
1495,8519.071920,117,1740059,59.28,4463.55
1496,8553.223545,65,1740124,59.25,4463.55
1497,8736.165377,193,1740317,59.21,4463.55
1498,8656.899920,149,1740466,59.18,4463.55
1499,8667.007905,115,1740581,59.14,4463.55
1500,8663.242270,136,1740717,59.11,4463.55
1501,8755.352923,67,1740784,59.08,4463.55
1502,8657.135875,159,1740943,59.10,4463.55
1503,8368.220691,84,1741027,59.07,4463.55
1504,8613.072529,80,1741107,59.06,4463.55
1505,8662.891542,82,1741189,59.06,4466.37
1506,8701.158755,195,1741384,59.04,4466.37
1507,8673.540758,126,1741510,59.03,4466.37
1508,8713.100701,138,1741648,59.02,4466.37
1509,8676.030475,123,1741771,59.01,4466.37
1510,8675.243920,67,1741838,59.00,4466.37
1511,8674.767411,107,1741945,59.05,4466.37
1512,8676.143579,84,1742029,59.03,4466.37
1513,8676.435330,92,1742121,59.02,4466.37
1514,8681.956902,71,1742192,59.01,4466.37
1515,8792.823003,257,1742449,58.99,4466.45
1516,8835.469175,62,1742511,58.95,4466.45
1517,8905.953660,140,1742651,58.95,4466.45
1518,8796.685582,129,1742780,59.01,4466.45
1519,8697.379772,121,1742901,59.03,4466.45
1520,8651.813026,62,1742963,59.01,4466.45
1521,8683.678641,97,1743060,58.98,4466.45
1522,8701.693511,66,1743126,58.95,4466.45
1523,8652.352855,131,1743257,58.92,4466.45
1524,8802.094881,192,1743449,58.88,4466.45
1525,8949.440286,69,1743518,58.85,4466.45
1526,8916.567807,135,1743653,58.82,4466.45
1527,9070.768124,131,1743784,58.79,4466.45
1528,8862.074599,158,1743942,58.76,4466.45
1529,8836.219740,22,1743964,58.73,4466.45
1530,8814.047183,96,1744060,58.69,4466.45
1531,8813.041641,66,1744126,58.70,4466.45
1532,8855.902973,192,1744318,58.73,4466.45
1533,8863.388308,134,1744452,58.78,4471.53
1534,8915.715470,67,1744519,58.75,4471.53
1535,8858.786182,135,1744654,58.72,4471.53
1536,8859.508133,131,1744785,58.68,4471.53
1537,8849.909583,157,1744942,58.65,4471.53
1538,8716.577985,87,1745029,58.62,4471.53
1539,8542.892224,1,1745030,58.59,4471.53
1540,9185.760864,93,1745123,58.55,4471.53
1541,9147.600215,195,1745318,58.52,4471.53
1542,0.000000,0,1745318,58.48,4471.53
1543,0.000000,0,1745318,58.45,4472.06
1544,0.000000,0,1745318,58.42,4472.06
1545,0.000000,0,1745318,58.45,4472.06
1546,0.000000,0,1745318,58.47,4476.24
1547,0.000000,0,1745318,58.44,4476.24
1548,0.000000,0,1745318,58.40,4476.24
1549,0.000000,0,1745318,58.37,4476.24
1550,0.000000,0,1745318,58.33,4476.24
1551,0.000000,0,1745318,58.30,4476.24
1552,0.000000,0,1745318,58.26,4476.24
1553,16173.102201,973,1746291,58.22,4476.24
1554,0.000000,0,1746291,58.20,4476.24
1555,0.000000,0,1746291,58.16,4476.24
1556,14315.780067,27,1746318,58.13,4476.24
1557,0.000000,0,1746318,58.09,4476.24
1558,0.000000,0,1746318,58.05,4476.24
1559,6021.820566,65,1746383,58.02,4476.24
1560,0.000000,0,1746383,57.98,4476.24
1561,0.000000,0,1746383,57.95,4476.24
1562,0.000000,0,1746383,57.91,4476.24
1563,0.000000,0,1746383,57.88,4476.24
1564,11125.687431,455,1746838,57.84,4476.24
1565,11333.632327,519,1747357,57.82,4476.24
1566,2110.219142,389,1747746,57.79,4476.24
1567,2333.373204,649,1748395,57.77,4476.24
1568,1959.490360,390,1748785,57.82,4476.41
1569,1650.532321,454,1749239,57.90,4476.41
1570,1974.365609,650,1749889,57.88,4476.41
1571,1931.699777,390,1750279,57.85,4476.41
1572,2016.008945,520,1750799,57.83,4476.41
1573,2182.753591,584,1751383,57.80,4476.41
1574,1924.604776,455,1751838,57.78,4476.41
1575,1764.909449,562,1752400,57.84,4478.50
1576,2075.337368,478,1752878,57.85,4478.50
1577,2010.045877,520,1753398,57.83,4478.50
1578,1924.193300,455,1753853,57.80,4478.50
1579,2064.189449,390,1754243,57.78,4478.50
1580,2549.066807,258,1754501,57.75,4478.50
1581,2836.823726,313,1754814,57.72,4478.50
1582,3326.325922,272,1755086,57.75,4478.50
1583,3554.065104,261,1755347,57.72,4478.50
1584,3745.999286,195,1755542,57.69,4478.50
1585,3833.159609,324,1755866,57.72,4478.50
1586,3879.047337,220,1756086,57.76,4478.50
1587,4079.484716,197,1756283,57.73,4478.50
1588,4108.933139,259,1756542,57.69,4478.50
1589,4105.627828,325,1756867,57.67,4478.94
1590,3990.127376,219,1757086,57.64,4478.94
1591,4033.135033,196,1757282,57.62,4478.94
1592,4231.222409,258,1757540,57.59,4478.94
1593,4320.226492,198,1757738,57.56,4478.94
1594,4418.114052,259,1757997,57.53,4478.94
1595,4370.033779,158,1758155,57.50,4478.94
1596,4386.689887,257,1758412,57.53,4478.94
1597,4351.404023,212,1758624,57.51,4478.94
1598,4329.755244,307,1758931,57.54,4478.94
1599,4472.800337,159,1759090,57.57,4478.94
1600,4501.358555,192,1759282,57.54,4478.94
1601,4704.381837,195,1759477,57.53,4478.94
1602,4749.056275,262,1759739,57.52,4478.94
1603,4694.813153,258,1759997,57.51,4478.94
1604,4740.416341,157,1760154,57.50,4478.94
1605,4747.525955,131,1760285,57.50,4478.94
1606,4730.076147,257,1760542,57.49,4489.14
1607,4757.605977,197,1760739,57.55,4495.30
1608,4687.671719,270,1761009,57.54,4495.30
1609,4651.177417,212,1761221,57.54,4495.30
1610,4615.570109,192,1761413,57.58,4495.30
1611,4678.472896,197,1761610,57.58,4495.30
1612,4894.245057,139,1761749,57.58,4495.30
1613,5202.095797,249,1761998,57.59,4495.30
1614,5305.142222,156,1762154,57.56,4495.30
1615,5396.790318,134,1762288,57.55,4495.30
1616,5428.719952,254,1762542,57.57,4495.30
1617,5452.952715,137,1762679,57.54,4495.30
1618,5480.493905,192,1762871,57.52,4495.30
1619,5635.643528,193,1763064,57.48,4495.30
1620,5561.407888,157,1763221,57.46,4495.30
1621,5804.888347,130,1763351,57.43,4495.30
1622,5954.103505,193,1763544,57.39,4495.30
1623,5819.803286,136,1763680,57.43,4495.30
1624,5980.635764,191,1763871,57.40,4495.30
1625,5982.339316,194,1764065,57.37,4495.30
1626,5995.897040,156,1764221,57.40,4495.30
1627,5939.703685,68,1764289,57.37,4495.30
1628,5952.062292,254,1764543,57.35,4495.30
1629,6136.463792,136,1764679,57.40,4496.16
1630,6102.692221,192,1764871,57.39,4496.16
1631,6115.506370,193,1765064,57.38,4496.16
1632,6868.989594,1,1765065,57.37,4496.16
1633,0.000000,0,1765065,57.36,4496.16
1634,8165.688683,93,1765158,57.41,4496.16
1635,8155.032801,131,1765289,57.40,4496.16
1636,8159.313071,202,1765491,57.38,4496.16
1637,8175.530340,122,1765613,57.43,4499.23
1638,8402.450917,147,1765760,57.41,4499.23
1639,8586.377219,176,1765936,57.38,4499.23
1640,8810.577768,130,1766066,57.35,4499.23
1641,6910.344817,92,1766158,57.31,4499.29
1642,7143.812571,71,1766229,57.29,4488.73
1643,7633.269008,124,1766353,57.27,4488.72
1644,7940.261106,136,1766489,57.29,4488.71
1645,8320.829466,58,1766547,57.26,4488.71
1646,8741.879772,132,1766679,57.23,4488.71
1647,8768.186912,126,1766805,57.20,4488.71
1648,8764.675302,135,1766940,57.17,4488.71
1649,8759.029595,149,1767089,57.14,4488.71
1650,8766.448591,132,1767221,57.14,4488.71
1651,8707.170053,66,1767287,57.14,4488.71
1652,8706.920069,127,1767414,57.11,4488.71
1653,8700.393010,78,1767492,57.07,4488.71
1654,8812.111173,57,1767549,57.04,4488.71
1655,8814.820707,131,1767680,57.01,4488.71
1656,9010.930568,126,1767806,56.98,4488.71
1657,8941.027983,134,1767940,56.99,4501.24
1658,9047.511394,66,1768006,56.98,4501.24
1659,9675.161181,59,1768065,56.95,4501.24
1660,0.000000,0,1768065,56.92,4501.24
1661,11323.182849,1,1768066,56.89,4501.24
1662,0.000000,0,1768066,56.86,4501.24
1663,0.000000,0,1768066,56.83,4501.24
1664,14351.616965,1,1768067,56.80,4501.24
1665,0.000000,0,1768067,56.77,4501.24
1666,16577.078780,112,1768179,56.79,4501.24
1667,13990.830735,512,1768691,56.76,4501.24
1668,10756.161138,375,1769066,56.74,4501.24
1669,2768.422340,241,1769307,56.72,4501.24
1670,2813.492490,448,1769755,56.75,4501.24
1671,2885.108092,310,1770065,56.73,4501.24
1672,3202.914506,114,1770179,56.69,4501.24
1673,3572.307910,194,1770373,56.66,4501.24
1674,4017.810918,257,1770630,56.63,4501.24
1675,4529.179885,255,1770885,56.61,4501.24
1676,4910.693420,125,1771010,56.58,4501.24
1677,5276.113946,105,1771115,56.55,4501.50
1678,5495.289854,68,1771183,56.52,4501.59
1679,5860.532921,127,1771310,56.55,4501.59
1680,6358.304552,190,1771500,56.58,4501.59
1681,6766.971553,130,1771630,56.55,4501.59
1682,7239.295642,127,1771757,56.53,4501.59
1683,7600.711894,190,1771947,56.49,4501.59
1684,7907.123637,64,1772011,56.46,4501.59
1685,8037.237996,61,1772072,56.43,4501.59
1686,8331.363283,109,1772181,56.40,4501.59
1687,8400.639485,126,1772307,56.38,4501.59
1688,8509.885284,66,1772373,56.35,4501.59
1689,8824.192086,127,1772500,56.32,4501.59
1690,9148.819228,128,1772628,56.29,4501.59
1691,9180.767972,129,1772757,56.26,4501.59
1692,9158.930528,189,1772946,56.29,4501.59
1693,9273.168370,64,1773010,56.26,4501.59
1694,9161.294013,61,1773071,56.34,4506.54
1695,9168.705032,52,1773123,56.32,4506.54
1696,9263.598969,126,1773249,56.29,4506.54
1697,9219.514397,123,1773372,56.27,4506.54
1698,9216.889742,128,1773500,56.24,4506.54
1699,9260.134737,69,1773569,56.21,4506.54
1700,9062.378207,231,1773800,56.18,4506.54
1701,7768.597435,318,1774118,56.15,4506.54
1702,6357.180653,105,1774223,56.13,4506.54
1703,6371.297046,90,1774313,56.10,4506.54
1704,6293.617038,125,1774438,56.07,4506.54
1705,6399.372320,70,1774508,56.06,4506.54
1706,6345.412898,129,1774637,56.08,4506.54
1707,6381.573787,294,1774931,56.05,4506.54
1708,6790.177432,192,1775123,56.14,4506.54
1709,6843.350397,124,1775247,56.11,4506.54
1710,6792.153947,125,1775372,56.08,4506.54
1711,6793.107503,67,1775439,56.06,4506.54
1712,6748.762132,129,1775568,56.03,4506.54
1713,6834.164480,125,1775693,56.00,4506.54
1714,6902.388514,238,1775931,55.98,4506.54
1715,7054.777337,192,1776123,55.95,4506.54
1716,7070.863397,124,1776247,55.92,4506.54
1717,7007.887172,125,1776372,55.89,4506.54
1718,7005.949831,67,1776439,55.87,4506.54
1719,7065.009447,129,1776568,55.89,4506.54
1720,7010.728017,125,1776693,55.86,4506.54
1721,7118.726933,174,1776867,55.88,4506.54
1722,7310.593587,251,1777118,55.92,4506.54
1723,7361.433283,68,1777186,55.89,4506.54
1724,7248.578737,129,1777315,55.87,4506.54
1725,7296.509190,122,1777437,55.84,4506.54
1726,7356.029817,71,1777508,55.81,4506.54
1727,7380.793314,124,1777632,55.79,4506.54
1728,7432.877120,226,1777858,55.76,4506.54
1729,7546.049861,140,1777998,55.73,4506.54
1730,7498.091319,126,1778124,55.70,4506.54
1731,7552.836723,127,1778251,55.68,4506.54
1732,7680.590778,124,1778375,55.65,4506.54
1733,7523.544101,113,1778488,55.68,4506.54
1734,7509.467946,80,1778568,55.65,4506.54
1735,7643.983562,126,1778694,55.72,4506.54
1736,7553.286663,173,1778867,55.70,4506.54
1737,7508.930373,251,1779118,55.69,4506.54
1738,7511.042130,70,1779188,55.66,4506.54
1739,7568.036542,122,1779310,55.64,4506.54
1740,7499.799737,125,1779435,55.61,4506.54
1741,7506.674784,75,1779510,55.58,4506.54
1742,7607.912592,129,1779639,55.55,4506.54
1743,7539.446471,155,1779794,55.53,4506.54
1744,7660.274862,104,1779898,55.53,4506.54
1745,7697.222818,225,1780123,55.57,4506.54
1746,7744.223356,124,1780247,55.57,4506.54
1747,7844.066993,71,1780318,55.56,4506.54
1748,7751.389428,120,1780438,55.55,4506.54
1749,7828.604258,74,1780512,55.60,4506.54
1750,7754.514565,126,1780638,55.64,4518.94
1751,7893.620766,122,1780760,55.63,4539.88
1752,7897.072978,238,1780998,55.68,4551.67
1753,7958.666984,131,1781129,55.67,4551.67
1754,7808.753153,118,1781247,55.65,4551.67
1755,7926.547957,73,1781320,55.62,4551.67
1756,7904.481636,120,1781440,55.60,4551.67
1757,7881.356601,74,1781514,55.56,4551.67
1758,8080.921677,125,1781639,55.54,4551.67
1759,7933.125826,122,1781761,55.52,4551.67
1760,8064.470511,173,1781934,55.48,4551.67
1761,8029.100816,191,1782125,55.46,4551.67
1762,8007.376429,125,1782250,55.44,4551.67
1763,8042.968383,70,1782320,55.47,4551.67
1764,7940.628423,120,1782440,55.49,4552.20
1765,7928.738445,74,1782514,55.52,4552.20
1766,7977.845257,126,1782640,55.50,4552.20
1767,7969.114706,122,1782762,55.47,4552.20
1768,7958.000527,172,1782934,55.44,4552.20
1769,7992.237905,192,1783126,55.42,4552.20
1770,7969.504198,124,1783250,55.40,4552.20
1771,7904.976006,72,1783322,55.37,4552.20
1772,7912.516494,119,1783441,55.34,4552.20
1773,8636.755639,74,1783515,55.32,4552.20
1774,0.000000,0,1783515,55.29,4552.20
1775,0.000000,0,1783515,55.26,4552.20
1776,0.000000,0,1783515,55.23,4552.20
1777,0.000000,0,1783515,55.27,4552.20
1778,0.000000,0,1783515,55.29,4552.20
1779,0.000000,0,1783515,55.25,4552.20
1780,0.000000,0,1783515,55.22,4552.20
1781,0.000000,0,1783515,55.20,4552.20
1782,12781.927744,992,1784507,55.17,4552.20
1783,0.000000,0,1784507,55.15,4552.20
1784,0.000000,0,1784507,55.13,4552.20
1785,0.000000,0,1784507,55.10,4552.20
1786,0.000000,0,1784507,55.07,4552.20
1787,0.000000,0,1784507,55.04,4552.20
1788,0.000000,0,1784507,55.01,4552.20
1789,0.000000,0,1784507,54.98,4552.20
1790,0.000000,0,1784507,54.95,4552.20
1791,0.000000,0,1784507,54.92,4552.20
1792,0.000000,0,1784507,54.91,4552.20
1793,0.000000,0,1784507,54.90,4552.12
1794,0.000000,0,1784507,54.88,4547.13
1795,13623.989549,268,1784775,54.87,4546.74
1796,0.000000,0,1784775,54.88,4546.74
1797,0.000000,0,1784775,54.95,4550.44
1798,16226.817848,260,1785035,54.96,4550.44
1799,14564.776843,583,1785618,54.97,4550.44
1800,3077.092625,390,1786008,55.00,4550.44
1801,1996.831962,553,1786561,55.06,4550.44
1802,2012.367168,603,1787164,55.08,4550.44
1803,1990.283005,337,1787501,55.16,4550.44
1804,2005.787742,585,1788086,55.16,4550.44
1805,2095.072601,585,1788671,55.20,4550.44
1806,2026.269385,454,1789125,55.20,4550.53
1807,1808.918811,520,1789645,55.18,4550.53
1808,1942.506774,520,1790165,55.16,4550.53
1809,2035.610984,451,1790616,55.14,4550.53
1810,2019.768029,524,1791140,55.17,4550.53
1811,2025.836257,520,1791660,55.16,4550.53
1812,1930.368558,455,1792115,55.19,4550.53
1813,1930.114561,519,1792634,55.17,4550.53
1814,2036.478866,429,1793063,55.15,4550.53
1815,2082.757449,351,1793414,55.15,4550.53
1816,2505.970824,325,1793739,55.15,4550.53
1817,3059.199600,259,1793998,55.13,4550.53
1818,3409.230784,261,1794259,55.11,4550.53
1819,3736.881793,259,1794518,55.08,4550.53
1820,3795.480785,261,1794779,55.06,4550.53
1821,3937.409683,260,1795039,55.05,4550.53
1822,3893.506169,219,1795258,55.09,4550.53
1823,4118.898490,260,1795518,55.10,4550.53
1824,4088.281163,197,1795715,55.07,4550.53
1825,4156.087967,196,1795911,55.05,4550.53
1826,4285.159866,283,1796194,55.02,4550.53
1827,4294.648575,260,1796454,55.00,4550.53
1828,4352.222017,85,1796539,54.97,4550.53
1829,5012.854713,44,1796583,54.96,4550.53
1830,6335.649491,1,1796584,54.96,4550.53
1831,0.000000,0,1796584,54.94,4550.53
1832,7944.476829,64,1796648,54.91,4550.53
1833,0.000000,0,1796648,54.88,4550.53
1834,9839.243454,1,1796649,54.86,4550.53
1835,0.000000,0,1796649,54.83,4550.53
1836,11778.902749,1,1796650,54.80,4550.53
1837,0.000000,0,1796650,54.77,4550.53
1838,13845.224636,64,1796714,54.74,4550.53
1839,0.000000,0,1796714,54.72,4550.53
1840,0.000000,0,1796714,54.69,4550.53
1841,16808.153633,1,1796715,54.66,4550.53
1842,0.000000,0,1796715,54.63,4550.53
1843,0.000000,0,1796715,54.60,4550.53
1844,0.000000,0,1796715,54.57,4550.53
1845,20328.112045,1,1796716,54.54,4550.53
1846,0.000000,0,1796716,54.51,4550.53
1847,0.000000,0,1796716,54.48,4550.53
1848,23788.352773,64,1796780,54.46,4550.53
1849,0.000000,0,1796780,54.43,4550.53
1850,0.000000,0,1796780,54.40,4550.53
1851,26600.979151,2,1796782,54.37,4550.53
1852,0.000000,0,1796782,54.34,4550.53
1853,28350.583598,127,1796909,54.31,4550.53
1854,28380.599514,155,1797064,54.29,4550.53
1855,28596.767909,197,1797261,54.27,4550.53
1856,28685.574523,258,1797519,54.24,4550.53
1857,26820.757159,130,1797649,54.22,4550.53
1858,14725.880478,133,1797782,54.19,4550.61
1859,5517.974490,130,1797912,54.22,4550.70
1860,6013.433162,132,1798044,54.25,4550.70
1861,6364.496512,149,1798193,54.23,4550.70
1862,6756.091254,132,1798325,54.25,4554.68
1863,7073.536245,193,1798518,54.23,4554.68
1864,7207.528047,67,1798585,54.21,4554.68
1865,7609.537067,129,1798714,54.18,4554.68
1866,7638.683819,133,1798847,54.16,4554.68
1867,7758.683151,67,1798914,54.14,4554.68
1868,7947.833110,130,1799044,54.11,4554.68
1869,8140.015341,87,1799131,54.09,4554.68
1870,8284.382307,67,1799198,54.06,4554.68
1871,8829.563118,127,1799325,54.04,4554.68
1872,9273.276312,69,1799394,54.02,4554.68
1873,9537.061055,126,1799520,54.11,4563.13
1874,9905.842679,63,1799583,54.12,4563.13
1875,10162.464127,68,1799651,54.09,4563.13
1876,10225.987126,133,1799784,54.07,4563.13
1877,10404.996911,126,1799910,54.05,4563.13
1878,10580.027373,68,1799978,54.02,4563.13
1879,10826.510065,67,1800045,54.00,4563.13
1880,11078.430426,85,1800130,53.97,4563.13
1881,11223.891904,67,1800197,53.95,4563.13
1882,11221.884681,68,1800265,53.93,4563.13
1883,11356.285505,65,1800330,53.90,4563.13
1884,11670.797919,124,1800454,53.93,4563.13
1885,11795.661529,68,1800522,53.91,4563.13
1886,11919.723897,62,1800584,53.88,4563.13
1887,11918.128032,68,1800652,53.92,4568.93
1888,12107.432764,130,1800782,53.94,4568.93
1889,12407.407570,68,1800850,53.92,4568.93
1890,12541.908282,64,1800914,53.89,4568.93
1891,12554.014277,68,1800982,53.87,4568.93
1892,12786.669444,81,1801063,53.85,4568.93
1893,12773.021770,70,1801133,53.83,4568.93
1894,12770.325995,66,1801199,53.80,4568.93
1895,12892.395511,68,1801267,53.83,4568.93
1896,12887.058398,64,1801331,53.81,4568.93
1897,13032.432901,85,1801416,53.78,4568.93
1898,13191.326694,105,1801521,53.76,4568.93
1899,13302.510393,61,1801582,53.74,4568.93
1900,13306.976562,68,1801650,53.71,4568.93
1901,13292.265203,67,1801717,53.75,4568.93
1902,13425.721338,69,1801786,53.76,4568.93
1903,13572.033165,67,1801853,53.78,4568.93
1904,13863.345834,63,1801916,53.82,4568.93
1905,13804.939047,67,1801983,53.82,4568.93
1906,13926.521694,64,1802047,53.81,4568.93
1907,14073.291964,84,1802131,53.81,4568.93
1908,14324.528576,65,1802196,53.80,4568.93
1909,14571.812330,65,1802261,53.79,4568.93
1910,14684.913568,9,1802270,53.79,4568.93
1911,14862.822838,62,1802332,53.83,4568.93
1912,14994.052887,84,1802416,53.81,4568.93
1913,15028.980141,104,1802520,53.78,4568.93
1914,15062.238248,61,1802581,53.76,4568.93
1915,15060.469334,68,1802649,53.79,4568.93
1916,15059.204324,68,1802717,53.77,4569.46
1917,15176.377714,68,1802785,53.79,4570.49
1918,15176.944787,66,1802851,53.76,4570.49
1919,15087.735625,65,1802916,53.74,4570.49
1920,15046.535626,67,1802983,53.71,4570.49
1921,15046.305719,64,1803047,53.69,4570.49
1922,15136.446726,83,1803130,53.71,4579.62
1923,15140.101373,65,1803195,53.70,4579.62
1924,15131.014621,10,1803205,53.67,4579.62
1925,15248.672079,62,1803267,53.65,4579.62
1926,15339.855721,63,1803330,53.62,4579.62
1927,15228.846044,65,1803395,53.60,4579.62
1928,15265.366413,123,1803518,53.58,4579.62
1929,15286.565205,61,1803579,53.60,4579.62
1930,15287.794144,8,1803587,53.58,4579.62
1931,15283.806157,127,1803714,53.61,4579.62
1932,0.000000,0,1803714,53.58,4579.62
1933,0.000000,0,1803714,53.56,4579.62
1934,16566.529449,197,1803911,53.53,4579.62
1935,0.000000,0,1803911,53.51,4579.62
1936,0.000000,0,1803911,53.49,4579.62
1937,0.000000,0,1803911,53.46,4579.62
1938,0.000000,0,1803911,53.43,4579.62
1939,0.000000,0,1803911,53.41,4579.62
1940,0.000000,0,1803911,53.40,4579.62
1941,0.000000,0,1803911,53.40,4579.62
1942,0.000000,0,1803911,53.44,4579.62
1943,0.000000,0,1803911,53.49,4578.44
1944,20080.409364,544,1804455,53.48,4565.67
1945,0.000000,0,1804455,53.48,4565.67
1946,0.000000,0,1804455,53.47,4565.67
1947,0.000000,0,1804455,53.46,4567.87
1948,0.000000,0,1804455,53.46,4586.43
1949,0.000000,0,1804455,53.49,4603.15
1950,0.000000,0,1804455,53.47,4603.15
1951,17438.686164,521,1804976,53.45,4603.15
1952,0.000000,0,1804976,53.42,4603.15
1953,0.000000,0,1804976,53.40,4603.15
1954,9777.856739,65,1805041,53.37,4603.15
1955,11427.957042,130,1805171,53.36,4603.15
1956,9601.496218,454,1805625,53.36,4603.15
1957,4125.371510,650,1806275,53.36,4603.15
1958,1828.944277,455,1806730,53.35,4603.15
1959,2134.129074,455,1807185,53.36,4603.15
1960,2044.719727,585,1807770,53.36,4603.15
1961,1839.741313,455,1808225,53.34,4603.15
1962,2249.094290,260,1808485,53.36,4603.15
1963,2740.651332,195,1808680,53.35,4603.15
1964,3225.454505,324,1809004,53.33,4603.15
1965,3781.853095,260,1809264,53.33,4603.15
1966,3815.647031,260,1809524,53.32,4603.15
1967,3858.125079,259,1809783,53.32,4603.15
1968,3893.086066,221,1810004,53.37,4603.15
1969,4049.666442,260,1810264,53.36,4603.15
1970,4105.806967,260,1810524,53.41,4603.15
1971,4018.595725,260,1810784,53.41,4603.15
1972,3988.066932,220,1811004,53.40,4603.15
1973,3977.143761,196,1811200,53.40,4603.15
1974,4115.199639,259,1811459,53.39,4625.41
1975,4211.550589,260,1811719,53.43,4637.72
1976,4288.818571,262,1811981,53.41,4637.72
1977,4341.144291,155,1812136,53.38,4637.72
1978,4243.145091,260,1812396,53.36,4637.72
1979,4266.414420,260,1812656,53.34,4637.72
1980,4250.434300,196,1812852,53.32,4637.72
1981,4328.475635,219,1813071,53.29,4637.72
1982,4257.147730,324,1813395,53.27,4637.72
1983,4297.453184,181,1813576,53.25,4637.72
1984,4277.236278,273,1813849,53.28,4637.72
1985,4453.027976,135,1813984,53.26,4637.72
1986,4686.520587,153,1814137,53.23,4637.72
1987,4740.835960,258,1814395,53.21,4637.72
1988,5020.106747,134,1814529,53.19,4637.72
1989,5343.866869,193,1814722,53.22,4637.72
1990,5419.477732,196,1814918,53.19,4637.72
1991,5371.165126,89,1815007,53.17,4637.72
1992,5513.077107,321,1815328,53.15,4637.72
1993,5460.597107,71,1815399,53.12,4637.72
1994,5563.628756,243,1815642,53.10,4637.72
1995,5546.139819,18,1815660,53.08,4637.72
1996,6179.689270,62,1815722,53.05,4637.72
1997,7233.413202,3,1815725,53.03,4637.72
1998,0.000000,0,1815725,53.01,4637.72
1999,8879.887644,64,1815789,52.98,4637.72
2000,0.000000,0,1815789,53.01,4637.72
2001,11421.041301,1,1815790,52.99,4637.72
2002,0.000000,0,1815790,52.96,4637.72
2003,0.000000,0,1815790,52.94,4637.72
2004,0.000000,0,1815790,52.91,4637.72
2005,15189.817062,60,1815850,52.89,4637.72
2006,0.000000,0,1815850,52.86,4637.72
2007,0.000000,0,1815850,52.84,4637.72
2008,17891.067834,1,1815851,52.82,4637.72
2009,0.000000,0,1815851,52.79,4637.72
2010,20176.413228,4,1815855,52.77,4637.72
2011,19348.000529,512,1816367,52.78,4637.72
2012,15841.554009,483,1816850,52.78,4637.72
2013,2539.996532,184,1817034,52.79,4637.72
2014,2975.302811,269,1817303,52.78,4637.72
2015,3482.053281,256,1817559,52.76,4637.72
2016,3918.856091,192,1817751,52.74,4637.72
2017,4253.503278,104,1817855,52.72,4637.72
2018,4725.583221,126,1817981,52.70,4637.72
2019,5536.485644,66,1818047,52.72,4637.72
2020,6101.988128,130,1818177,52.70,4637.72
2021,6455.016684,190,1818367,52.68,4637.72
2022,6973.641820,129,1818496,52.65,4637.72
2023,7285.535162,129,1818625,52.64,4637.72
2024,7639.906441,166,1818791,52.61,4637.72
2025,8028.782924,63,1818854,52.59,4637.72
2026,8252.526866,70,1818924,52.57,4637.72
2027,8445.733269,94,1819018,52.63,4637.72
2028,8677.142963,31,1819049,52.63,4637.72
2029,8987.324538,128,1819177,52.61,4637.72
2030,9208.993276,128,1819305,52.64,4637.72
2031,9534.437512,105,1819410,52.62,4637.72
2032,9236.400948,214,1819624,52.60,4637.72
2033,9342.891506,126,1819750,52.58,4637.72
2034,9708.655227,43,1819793,52.56,4637.72
2035,9855.473443,63,1819856,52.53,4637.72
2036,10084.058765,65,1819921,52.51,4637.72
2037,10379.543690,62,1819983,52.49,4637.72
2038,10621.595678,39,1820022,52.47,4637.72
2039,10832.714071,27,1820049,52.45,4637.72
2040,11088.340546,66,1820115,52.47,4637.72
2041,11284.454927,189,1820304,52.50,4637.72
2042,11222.120797,66,1820370,52.52,4637.72
2043,11215.027932,195,1820565,52.50,4637.72
2044,11364.341940,123,1820688,52.48,4637.72
2045,11650.379388,66,1820754,52.46,4637.72
2046,11740.622091,96,1820850,52.43,4637.72
2047,11859.928599,9,1820859,52.41,4637.72
2048,12239.613838,60,1820919,52.39,4637.72
2049,12501.453354,60,1820979,52.37,4637.72
2050,12642.216751,7,1820986,52.35,4637.72
2051,12794.710202,38,1821024,52.32,4637.72
2052,13131.416235,24,1821048,52.30,4637.72
2053,13332.567659,66,1821114,52.28,4637.72
2054,13203.013083,131,1821245,52.30,4637.72
2055,13281.304166,123,1821368,52.34,4640.71
2056,13319.701569,194,1821562,52.33,4640.71
2057,13285.270426,124,1821686,52.34,4647.00
2058,13219.776177,65,1821751,52.32,4647.00
2059,13222.011630,43,1821794,52.30,4647.00
2060,13218.736978,61,1821855,52.28,4647.00
2061,13216.152922,12,1821867,52.26,4647.00
2062,13230.802883,60,1821927,52.24,4647.00
2063,13209.005676,58,1821985,52.22,4647.00
2064,13223.151787,36,1822021,52.19,4647.00
2065,13214.934512,20,1822041,52.17,4647.00
2066,13235.236725,71,1822112,52.15,4647.00
2067,13321.385337,129,1822241,52.13,4647.00
2068,13233.510800,68,1822309,52.13,4647.00
2069,13305.841492,165,1822474,52.17,4649.82
2070,13299.452194,151,1822625,52.19,4653.31
2071,13243.662541,68,1822693,52.19,4653.31
2072,13234.467255,99,1822792,52.17,4653.31
2073,13357.964675,60,1822852,52.15,4653.31
2074,13329.508562,12,1822864,52.13,4653.31
2075,13354.517221,59,1822923,52.11,4653.31
2076,13356.078077,59,1822982,52.09,4653.31
2077,13354.325848,36,1823018,52.07,4653.31
2078,13349.048779,21,1823039,52.04,4653.31
2079,13347.433047,13,1823052,52.02,4653.31
2080,13360.697044,89,1823141,52.00,4653.31
2081,13410.332951,164,1823305,51.98,4653.31
2082,13336.909408,67,1823372,51.96,4653.31
2083,13379.250268,198,1823570,52.01,4653.31
2084,13410.568912,121,1823691,52.01,4653.31
2085,13348.117786,69,1823760,52.04,4653.31
2086,13453.137961,37,1823797,52.02,4653.31
2087,13465.224173,62,1823859,52.00,4653.31
2088,13362.770424,60,1823919,51.98,4653.31
2089,13347.112375,60,1823979,51.96,4653.31
2090,13383.912211,8,1823987,51.94,4653.31
2091,13375.267874,36,1824023,51.92,4653.31
2092,13355.070377,25,1824048,51.90,4646.66
2093,13356.843480,68,1824116,51.87,4646.66
2094,13409.775679,127,1824243,51.85,4646.66
2095,13366.038460,126,1824369,51.83,4646.66
2096,13398.505912,193,1824562,51.81,4646.66
2097,13359.111747,97,1824659,51.84,4646.66
2098,13380.012918,96,1824755,51.87,4646.66
2099,13362.869920,39,1824794,51.91,4646.66
2100,13360.795447,61,1824855,51.90,4646.66
2101,13340.929107,12,1824867,51.90,4646.84
2102,13360.169760,62,1824929,51.89,4646.93
2103,13351.762488,55,1824984,51.89,4646.93
2104,13351.604503,36,1825020,51.88,4647.61
2105,13364.653366,21,1825041,51.87,4647.61
2106,13379.081504,71,1825112,51.91,4653.15
2107,13419.108186,67,1825179,51.91,4653.15
2108,13380.120861,128,1825307,51.90,4653.15
2109,13435.274248,132,1825439,51.89,4653.15
2110,13370.724352,187,1825626,51.87,4653.15
2111,13452.281570,69,1825695,51.90,4653.15
2112,13398.913808,97,1825792,51.93,4653.15
2113,13460.037168,61,1825853,51.91,4653.15
2114,13360.265314,11,1825864,51.89,4653.15
2115,13363.305783,59,1825923,51.89,4653.15
2116,13473.283523,57,1825980,51.88,4653.15
2117,13370.930950,10,1825990,51.92,4653.15
2118,13366.283238,36,1826026,51.92,4653.15
2119,13382.507712,24,1826050,51.92,4653.15
2120,13383.763035,68,1826118,51.95,4653.15
2121,13466.790538,128,1826246,51.96,4653.15
2122,13431.185614,124,1826370,51.95,4653.15
2123,13455.344436,199,1826569,51.95,4653.15
2124,13498.630982,120,1826689,51.94,4653.15
2125,13614.774279,65,1826754,51.93,4653.15
2126,13614.310149,40,1826794,51.95,4653.15
2127,13622.097755,63,1826857,51.93,4653.15
2128,13624.773169,12,1826869,51.90,4653.15
2129,13623.264784,60,1826929,51.88,4653.15
2130,13618.705282,54,1826983,51.90,4653.15
2131,13612.653721,36,1827019,51.89,4653.15
2132,13715.207674,22,1827041,51.87,4653.15
2133,13738.065426,14,1827055,51.85,4653.15
2134,13677.065857,90,1827145,51.82,4653.15
2135,13669.681459,163,1827308,51.81,4653.15
2136,13602.092476,130,1827438,51.79,4653.15
2137,13657.028248,187,1827625,51.76,4653.15
2138,13473.104454,69,1827694,51.74,4653.15
2139,13486.900313,68,1827762,51.72,4653.15
2140,13511.067055,91,1827853,51.75,4653.15
2141,13436.939220,8,1827861,51.73,4653.15
2142,13582.508315,58,1827919,51.71,4653.15
2143,13578.195635,61,1827980,51.70,4653.15
2144,13547.400096,9,1827989,51.72,4653.15
2145,13684.671485,29,1828018,51.73,4653.15
2146,14874.739579,1,1828019,51.73,4653.15
2147,0.000000,0,1828019,51.72,4653.15
2148,16711.097225,1,1828020,51.71,4653.15
2149,0.000000,0,1828020,51.71,4662.30
2150,18049.966974,2,1828022,51.70,4663.51
2151,0.000000,0,1828022,51.73,4663.69
2152,20191.035487,1,1828023,51.73,4663.69
2153,0.000000,0,1828023,51.71,4663.69
2154,0.000000,0,1828023,51.69,4663.69
2155,23406.852978,1,1828024,51.67,4663.69
2156,0.000000,0,1828024,51.69,4663.69
2157,0.000000,0,1828024,51.66,4663.69
2158,0.000000,0,1828024,51.64,4663.69
2159,26683.792058,2,1828026,51.62,4663.69
2160,0.000000,0,1828026,51.60,4663.69
2161,0.000000,0,1828026,51.58,4663.69
2162,29984.534734,1,1828027,51.55,4663.69
2163,0.000000,0,1828027,51.53,4663.69
2164,0.000000,0,1828027,51.51,4663.69
2165,0.000000,0,1828027,51.48,4663.69
2166,33663.181939,1,1828028,51.46,4663.69
2167,32770.028543,289,1828317,51.44,4663.69
2168,30376.515321,511,1828828,51.43,4663.69
2169,25432.191512,199,1829027,51.41,4663.69
2170,2938.113324,354,1829381,51.43,4663.69
2171,2936.029397,511,1829892,51.42,4663.69
2172,2931.749507,136,1830028,51.40,4663.69
2173,3183.895169,129,1830157,51.39,4663.69
2174,3531.466136,225,1830382,51.42,4663.69
2175,4040.771608,127,1830509,51.39,4663.69
2176,4833.625542,319,1830828,51.37,4663.69
2177,0.000000,0,1830828,51.36,4663.69
2178,0.000000,0,1830828,51.34,4663.69
2179,6707.352364,361,1831189,51.31,4663.69
2180,0.000000,0,1831189,51.29,4663.69
2181,0.000000,0,1831189,51.28,4663.69
2182,0.000000,0,1831189,51.25,4663.69
2183,0.000000,0,1831189,51.23,4663.69
2184,0.000000,0,1831189,51.24,4663.69
2185,9989.240482,710,1831899,51.24,4663.69
2186,4685.091443,454,1832353,51.26,4663.69
2187,1459.981576,455,1832808,51.25,4663.69
2188,1974.894199,455,1833263,51.24,4663.69
2189,2061.394148,454,1833717,51.22,4663.69
2190,2736.157511,260,1833977,51.20,4663.69
2191,2981.397375,196,1834173,51.18,4663.69
2192,3475.731480,260,1834433,51.16,4663.69
2193,3875.738512,324,1834757,51.14,4663.69
2194,3821.955709,196,1834953,51.13,4663.69
2195,3929.487244,259,1835212,51.11,4663.69
2196,3979.625766,220,1835432,51.10,4663.69
2197,4186.912335,261,1835693,51.12,4663.69
2198,4094.794829,259,1835952,51.20,4663.69
2199,3968.406798,261,1836213,51.18,4663.69
2200,4043.440109,220,1836433,51.16,4663.69
2201,4262.120081,195,1836628,51.14,4663.69
2202,4286.368605,260,1836888,51.13,4663.69
2203,4384.887095,259,1837147,51.11,4663.69
2204,4479.771218,196,1837343,51.09,4663.69
2205,4391.317559,219,1837562,51.07,4663.69
2206,4429.277708,198,1837760,51.05,4663.69
2207,4402.491074,259,1838019,51.04,4663.69
2208,4379.509231,195,1838214,51.02,4663.69
2209,4373.981828,220,1838434,51.00,4663.69
2210,4410.007201,261,1838695,50.98,4663.69
2211,4391.632342,197,1838892,51.01,4663.69
2212,4442.887649,256,1839148,51.08,4663.69
2213,4516.595769,195,1839343,51.06,4663.69
2214,4696.381401,160,1839503,51.05,4663.69
2215,4553.662495,258,1839761,51.03,4663.69
2216,4669.271200,197,1839958,51.01,4663.69
2217,4867.169337,255,1840213,50.99,4663.69
2218,4835.319961,155,1840368,50.97,4663.69
2219,4834.619246,133,1840501,50.95,4663.69
2220,5165.432089,195,1840696,50.94,4663.69
2221,5118.589044,261,1840957,50.92,4663.69
2222,5126.558913,192,1841149,50.90,4663.69
2223,5087.376128,219,1841368,50.88,4663.69
2224,5125.083084,105,1841473,50.86,4663.69
2225,5291.503476,224,1841697,50.89,4663.69
2226,5117.413664,260,1841957,50.96,4663.69
2227,5042.895968,192,1842149,50.94,4663.69
2228,4994.544325,219,1842368,50.92,4663.69
2229,4933.918510,93,1842461,50.91,4663.69
2230,4988.261591,235,1842696,50.89,4663.69
2231,5087.694318,196,1842892,50.87,4663.69
2232,5241.213192,256,1843148,50.85,4663.69
2233,5338.924651,195,1843343,50.83,4663.69
2234,5450.108930,94,1843437,50.81,4663.69
2235,5335.555404,114,1843551,50.79,4663.69
2236,5511.859731,211,1843762,50.78,4663.69
2237,5499.561422,202,1843964,50.76,4663.69
2238,5545.708267,197,1844161,50.74,4663.69
2239,5485.328798,212,1844373,50.77,4663.69
2240,5475.539027,131,1844504,50.84,4663.69
2241,5347.540104,193,1844697,50.82,4663.69
2242,5427.620657,197,1844894,50.81,4663.69
2243,5382.644586,195,1845089,50.79,4663.69
2244,5547.938531,193,1845282,50.77,4663.69
2245,5534.473655,157,1845439,50.75,4663.69
2246,5469.978741,177,1845616,50.73,4663.69
2247,5520.641592,149,1845765,50.71,4663.69
2248,5625.704111,199,1845964,50.70,4663.69
2249,5586.498238,189,1846153,50.68,4663.69
2250,5661.593511,192,1846345,50.66,4663.69
2251,5589.481671,118,1846463,50.64,4663.69
2252,5639.466390,170,1846633,50.62,4663.69
2253,5625.608319,221,1846854,50.66,4663.69
2254,5675.228325,235,1847089,50.70,4663.69
2255,5605.697064,192,1847281,50.71,4663.69
2256,5563.997282,156,1847437,50.69,4663.69
2257,5607.936382,115,1847552,50.68,4663.69
2258,5578.202703,212,1847764,50.66,4663.69
2259,5686.719567,196,1847960,50.63,4663.69
2260,5684.184940,189,1848149,50.62,4663.69
2261,5806.395288,132,1848281,50.60,4663.69
2262,5860.222708,162,1848443,50.58,4663.69
2263,5824.358493,174,1848617,50.57,4663.69
2264,5737.105406,151,1848768,50.55,4663.69
2265,5727.814087,197,1848965,50.53,4663.69
2266,5730.009670,189,1849154,50.51,4663.69
2267,5848.849212,192,1849346,50.53,4663.69
2268,5757.978601,117,1849463,50.57,4663.69
2269,5866.630356,171,1849634,50.59,4663.69
2270,5945.774160,197,1849831,50.57,4663.69
2271,5895.846132,134,1849965,50.55,4663.69
2272,5999.053209,189,1850154,50.54,4663.69
2273,6013.714898,129,1850283,50.52,4663.69
2274,5927.179739,180,1850463,50.50,4663.69
2275,5848.987785,171,1850634,50.48,4663.69
2276,5822.857851,200,1850834,50.47,4663.69
2277,5889.203343,192,1851026,50.44,4663.69
2278,5820.072428,130,1851156,50.43,4663.69
2279,5822.634732,191,1851347,50.41,4663.69
2280,5882.830418,130,1851477,50.39,4663.69
2281,6078.746223,160,1851637,50.39,4663.69
2282,5975.409167,197,1851834,50.44,4663.69
2283,5958.817101,132,1851966,50.47,4663.69
2284,6037.517311,190,1852156,50.45,4663.69
2285,6036.542912,191,1852347,50.44,4663.69
2286,6022.863395,130,1852477,50.42,4663.69
2287,5939.547649,161,1852638,50.40,4663.69
2288,6003.595105,197,1852835,50.38,4663.69
2289,5940.996822,192,1853027,50.36,4663.69
2290,5938.537873,130,1853157,50.35,4663.69
2291,5982.517967,191,1853348,50.33,4663.69
2292,6019.685942,131,1853479,50.31,4663.69
2293,5937.834177,158,1853637,50.30,4663.69
2294,5972.343745,197,1853834,50.28,4663.69
2295,6053.162022,136,1853970,50.26,4663.69
2296,6152.108956,186,1854156,50.34,4663.69
2297,6102.781022,133,1854289,50.38,4663.69
2298,6244.721816,188,1854477,50.38,4663.69
2299,6182.310933,143,1854620,50.37,4663.69
2300,6194.844457,213,1854833,50.37,4663.69
2301,6152.812762,133,1854966,50.36,4663.69
2302,6169.413341,188,1855154,50.36,4663.69
2303,6258.878699,70,1855224,50.39,4677.85
2304,6169.642148,223,1855447,50.40,4678.12
2305,6147.872392,173,1855620,50.40,4678.12
2306,6187.514570,151,1855771,50.39,4678.12
2307,6154.110266,171,1855942,50.38,4678.12
2308,6294.834292,152,1856094,50.36,4678.12
2309,6275.958145,129,1856223,50.34,4678.12
2310,6331.092388,190,1856413,50.37,4678.12
2311,6455.346661,77,1856490,50.39,4678.12
2312,6473.616176,153,1856643,50.37,4678.12
2313,6466.161407,232,1856875,50.36,4678.12
2314,6358.799732,153,1857028,50.34,4678.12
2315,6413.985470,131,1857159,50.36,4678.12
2316,6408.773711,67,1857226,50.35,4678.12
2317,6555.652758,221,1857447,50.33,4678.12
2318,6557.260778,172,1857619,50.31,4678.12
2319,6677.938273,151,1857770,50.30,4678.12
2320,6667.793352,171,1857941,50.28,4678.12
2321,6732.422389,153,1858094,50.26,4678.12
2322,6661.163458,68,1858162,50.24,4678.12
2323,6666.478167,251,1858413,50.22,4678.12
2324,6628.076148,77,1858490,50.23,4678.12
2325,6617.501328,150,1858640,50.23,4678.12
2326,6577.151208,196,1858836,50.26,4680.25
2327,6659.160707,132,1858968,50.24,4680.25
2328,6603.742815,189,1859157,50.22,4680.25
2329,6645.594263,70,1859227,50.25,4681.04
2330,6742.765034,187,1859414,50.23,4681.04
2331,6676.278228,123,1859537,50.22,4681.04
2332,6717.287260,108,1859645,50.21,4681.04
2333,6836.691903,192,1859837,50.21,4681.04
2334,6831.975127,132,1859969,50.20,4681.04
2335,6948.863346,189,1860158,50.20,4681.04
2336,6679.308953,72,1860230,50.24,4681.04
2337,6743.572338,189,1860419,50.23,4681.04
2338,6669.730109,200,1860619,50.23,4681.04
2339,6675.401595,89,1860708,50.26,4681.04
2340,6764.154080,168,1860876,50.26,4681.04
2341,6823.300878,94,1860970,50.25,4681.04
2342,6940.516579,190,1861160,50.24,4681.04
2343,6920.007393,71,1861231,50.23,4681.04
2344,6918.375086,245,1861476,50.25,4681.04
2345,6957.002053,144,1861620,50.24,4681.04
2346,6992.764711,88,1861708,50.22,4681.04
2347,7041.853103,168,1861876,50.21,4681.04
2348,7033.409771,94,1861970,50.18,4681.04
2349,6998.299563,190,1862160,50.16,4681.04
2350,7014.950672,70,1862230,50.15,4681.04
2351,7036.968361,246,1862476,50.13,4681.04
2352,7116.886830,81,1862557,50.11,4681.04
2353,7061.278354,151,1862708,50.13,4681.04
2354,7012.104424,168,1862876,50.12,4681.04
2355,7127.198854,73,1862949,50.10,4681.04
2356,7165.731168,180,1863129,50.08,4681.04
2357,7156.719955,99,1863228,50.06,4681.04
2358,7328.240214,188,1863416,50.05,4681.04
2359,7350.784171,123,1863539,50.07,4688.27
2360,7311.493724,106,1863645,50.06,4688.27
2361,7315.684781,194,1863839,50.04,4688.27
2362,7435.758298,105,1863944,50.02,4688.27
2363,7730.254406,4,1863948,50.00,4688.27
2364,0.000000,0,1863948,49.98,4688.27
2365,9596.530089,1,1863949,49.96,4688.27
2366,0.000000,0,1863949,49.94,4688.27
2367,11141.121653,2,1863951,49.92,4688.27
2368,0.000000,0,1863951,49.94,4688.27
2369,13677.661898,20,1863971,49.93,4688.27
2370,0.000000,0,1863971,49.91,4688.27
2371,0.000000,0,1863971,49.89,4688.27
2372,15864.591630,61,1864032,49.88,4688.27
2373,17312.469594,31,1864063,49.88,4688.27
2374,16322.879696,448,1864511,49.92,4688.27
2375,13925.226110,442,1864953,49.92,4688.27
2376,3649.904409,174,1865127,49.92,4688.27
2377,2975.008565,256,1865383,49.91,4688.27
2378,3626.990993,256,1865639,49.91,4688.27
2379,4132.616676,256,1865895,49.91,4688.27
2380,4575.890092,80,1865975,49.95,4688.27
2381,4831.607890,152,1866127,49.94,4688.27
2382,5148.834502,130,1866257,49.98,4688.27
2383,5538.139109,191,1866448,49.96,4688.27
2384,5827.704500,191,1866639,49.94,4688.27
2385,6135.727435,130,1866769,49.92,4688.27
2386,6363.858663,185,1866954,49.91,4688.27
2387,6751.548752,79,1867033,49.89,4688.27
2388,6984.248567,54,1867087,49.89,4688.27
2389,7225.930435,103,1867190,49.89,4688.27
2390,7937.210136,68,1867258,49.89,4688.27
2391,8133.124209,128,1867386,49.87,4688.27
2392,8387.434726,128,1867514,49.85,4688.27
2393,8651.353508,128,1867642,49.84,4688.27
2394,8941.934734,127,1867769,49.82,4688.27
2395,9267.612428,128,1867897,49.80,4688.27
2396,9527.281437,76,1867973,49.83,4688.27
2397,9896.982519,61,1868034,49.82,4688.27
2398,10050.712922,31,1868065,49.83,4688.27
2399,10265.849432,111,1868176,49.82,4688.27
2400,10372.523295,19,1868195,49.80,4688.27
2401,10662.171135,126,1868321,49.78,4688.27
2402,10862.366455,66,1868387,49.80,4704.48
2403,11125.325768,125,1868512,49.79,4704.56
2404,10215.679976,358,1868870,49.77,4704.56
2405,8112.044333,193,1869063,49.75,4704.56
2406,7092.985811,67,1869130,49.74,4704.56
2407,0.000000,0,1869130,49.72,4704.56
2408,7772.219457,129,1869259,49.70,4704.56
2409,0.000000,0,1869259,49.68,4704.56
2410,7706.104101,253,1869512,49.66,4704.56
2411,0.000000,0,1869512,49.69,4707.77
2412,0.000000,0,1869512,49.71,4707.77
2413,0.000000,0,1869512,49.69,4707.77
2414,0.000000,0,1869512,49.67,4707.77
2415,0.000000,0,1869512,49.65,4707.77
2416,0.000000,0,1869512,49.63,4707.77
2417,0.000000,0,1869512,49.61,4707.77
2418,12976.132898,802,1870314,49.60,4707.77
2419,0.000000,0,1870314,49.58,4707.77
2420,0.000000,0,1870314,49.56,4707.77
2421,0.000000,0,1870314,49.54,4707.77
2422,11732.432469,1,1870315,49.52,4707.77
2423,0.000000,0,1870315,49.50,4707.77
2424,0.000000,0,1870315,49.48,4707.77
2425,0.000000,0,1870315,49.46,4707.77
2426,0.000000,0,1870315,49.45,4707.77
2427,16904.699685,130,1870445,49.43,4707.77
2428,0.000000,0,1870445,49.41,4707.77
2429,18730.680611,65,1870510,49.39,4707.77
2430,0.000000,0,1870510,49.37,4707.77
2431,0.000000,0,1870510,49.35,4707.77
2432,13668.203805,520,1871030,49.33,4707.77
2433,14187.291195,65,1871095,49.32,4707.77
2434,6739.207867,779,1871874,49.31,4708.10
2435,1753.372026,520,1872394,49.34,4708.10
2436,1985.008533,650,1873044,49.33,4708.10
2437,1912.497709,520,1873564,49.31,4708.10
2438,1981.147211,455,1874019,49.34,4708.10
2439,2248.327776,520,1874539,49.33,4708.10
2440,1899.864262,519,1875058,49.33,4708.10
2441,1869.098418,455,1875513,49.35,4708.10
2442,2026.106155,543,1876056,49.38,4708.10
2443,2148.489583,497,1876553,49.37,4708.10
2444,2032.599217,325,1876878,49.35,4708.10
2445,1872.749342,715,1877593,49.38,4708.10
2446,2026.397353,455,1878048,49.37,4708.10
2447,1906.287173,195,1878243,49.35,4708.10
2448,2156.104098,779,1879022,49.34,4708.10
2449,1707.441983,585,1879607,49.33,4708.10
2450,2114.892095,324,1879931,49.31,4708.10
2451,2678.934964,196,1880127,49.30,4708.10
2452,2993.963024,260,1880387,49.29,4708.10
2453,3523.550992,259,1880646,49.27,4708.10
2454,3875.368087,261,1880907,49.29,4708.10
2455,3913.962514,259,1881166,49.36,4708.10
2456,3854.685217,260,1881426,49.35,4708.10
2457,4025.232551,222,1881648,49.33,4708.10
2458,3958.543804,259,1881907,49.32,4708.10
2459,3982.901319,260,1882167,49.30,4708.10
2460,3982.425565,260,1882427,49.29,4708.10
2461,4026.665490,220,1882647,49.27,4708.10
2462,3984.558203,260,1882907,49.25,4708.10
2463,4106.283978,259,1883166,49.23,4708.10
2464,4137.595451,260,1883426,49.22,4708.10
2465,4071.051977,157,1883583,49.21,4708.10
2466,4091.185680,324,1883907,49.19,4708.10
2467,4091.112613,259,1884166,49.17,4708.10
2468,4101.124935,136,1884302,49.16,4708.10
2469,4317.807155,218,1884520,49.27,4708.10
2470,4403.560908,258,1884778,49.26,4708.10
2471,4438.079905,197,1884975,49.24,4708.10
2472,4501.151440,257,1885232,49.22,4708.10
2473,4599.586683,136,1885368,49.21,4708.10
2474,4637.571186,280,1885648,49.19,4708.10
2475,4659.737274,259,1885907,49.18,4708.10
2476,4570.875989,135,1886042,49.16,4708.10
2477,4771.414431,192,1886234,49.15,4708.10
2478,4922.172695,195,1886429,49.13,4708.10
2479,4863.626604,220,1886649,49.11,4708.10
2480,4999.834173,135,1886784,49.10,4708.10
2481,5155.521019,256,1887040,49.09,4708.10
2482,5158.285512,155,1887195,49.07,4708.10
2483,5243.083989,175,1887370,49.17,4708.10
2484,5201.728688,278,1887648,49.16,4708.10
2485,5255.764958,136,1887784,49.15,4708.10
2486,5395.050763,192,1887976,49.13,4708.10
2487,5489.235432,194,1888170,49.12,4708.10
2488,5457.357414,131,1888301,49.11,4708.10
2489,5633.401766,129,1888430,49.11,4709.04
2490,5784.372596,218,1888648,49.10,4709.04
2491,5810.963023,136,1888784,49.10,4709.04
2492,5862.709367,195,1888979,49.10,4709.04
2493,5872.297614,130,1889109,49.15,4709.04
2494,6023.320508,194,1889303,49.17,4709.04
2495,5920.857104,154,1889457,49.21,4709.04
2496,5897.793844,194,1889651,49.23,4709.04
2497,5864.899991,199,1889850,49.24,4709.04
2498,5795.836086,132,1889982,49.29,4709.04
2499,5897.126897,191,1890173,49.29,4709.04
2500,5871.546955,132,1890305,49.29,4709.04
2501,5856.484015,154,1890459,49.29,4709.04
2502,5849.656663,196,1890655,49.33,4709.04
2503,5800.219565,198,1890853,49.37,4716.34
2504,5802.145645,189,1891042,49.37,4716.34
2505,5926.295989,131,1891173,49.36,4716.34
2506,5932.565118,132,1891305,49.34,4716.34
2507,5968.569972,154,1891459,49.32,4716.34
2508,6057.834592,196,1891655,49.31,4716.34
2509,6052.483131,136,1891791,49.29,4716.34
2510,6117.579313,251,1892042,49.28,4716.34
2511,6168.370663,119,1892161,49.26,4716.34
2512,6165.630054,146,1892307,49.29,4716.34
2513,6109.789653,131,1892438,49.28,4716.34
2514,6122.400304,153,1892591,49.26,4716.34
2515,6179.432339,197,1892788,49.25,4716.34
2516,6289.027064,190,1892978,49.29,4721.90
2517,6292.126927,71,1893049,49.29,4724.91
2518,6329.109187,192,1893241,49.28,4724.91
2519,6297.002312,134,1893375,49.26,4724.91
2520,6436.296514,212,1893587,49.25,4724.91
2521,6679.128637,130,1893717,49.23,4724.91
2522,6696.537287,74,1893791,49.21,4724.91
2523,6799.311230,124,1893915,49.20,4724.91
2524,7524.186062,1,1893916,49.18,4724.91
2525,9025.473620,61,1893977,49.16,4724.91
2526,0.000000,0,1893977,49.14,4724.91
2527,10526.892565,1,1893978,49.12,4724.91
2528,11719.631833,6,1893984,49.10,4724.91
2529,0.000000,0,1893984,49.08,4724.91
2530,13749.598595,1,1893985,49.07,4724.91
2531,0.000000,0,1893985,49.05,4724.91
2532,0.000000,0,1893985,49.03,4724.91
2533,15814.063488,57,1894042,49.01,4724.91
2534,0.000000,0,1894042,48.99,4724.91
2535,0.000000,0,1894042,48.97,4724.91
2536,19078.506446,1,1894043,48.96,4724.91
2537,0.000000,0,1894043,48.94,4724.91
2538,0.000000,0,1894043,48.92,4724.91
2539,22088.512245,1,1894044,48.90,4724.91
2540,0.000000,0,1894044,48.88,4724.91
2541,0.000000,0,1894044,48.86,4724.91
2542,24959.044318,1,1894045,48.84,4703.20
2543,0.000000,0,1894045,48.82,4703.20
2544,27083.019258,2,1894047,48.80,4703.20
2545,0.000000,0,1894047,48.78,4703.20
2546,0.000000,0,1894047,48.76,4703.20
2547,29671.085794,2,1894049,48.75,4703.20
2548,0.000000,0,1894049,48.73,4703.20
2549,0.000000,0,1894049,48.71,4703.20
2550,32328.258872,169,1894218,48.70,4703.20
2551,32344.316216,152,1894370,48.73,4703.20
2552,32335.236769,133,1894503,48.71,4703.20
2553,32454.972377,89,1894592,48.70,4703.20
2554,32477.185805,192,1894784,48.68,4703.20
2555,32547.379100,131,1894915,48.67,4703.20
2556,30153.988193,71,1894986,48.69,4703.20
2557,22670.148117,64,1895050,48.71,4707.42
2558,7856.545512,167,1895217,48.70,4707.42
2559,8309.380193,92,1895309,48.68,4707.42
2560,8619.899214,66,1895375,48.67,4707.42
2561,8929.708644,107,1895482,48.65,4707.42
2562,9097.728201,108,1895590,48.68,4707.42
2563,9353.331645,128,1895718,48.68,4707.42
2564,9473.999281,74,1895792,48.68,4707.42
2565,9597.805262,185,1895977,48.67,4707.42
2566,9600.628003,67,1896044,48.67,4707.42
2567,9712.970083,68,1896112,48.67,4708.92
2568,9931.075807,105,1896217,48.68,4727.74
2569,10100.562222,28,1896245,48.70,4728.36
2570,10366.247423,124,1896369,48.74,4728.36
2571,10590.611000,10,1896379,48.76,4728.36
2572,10902.562454,124,1896503,48.78,4731.72
2573,11142.023557,86,1896589,48.76,4731.72
2574,11263.116706,67,1896656,48.75,4731.72
2575,11464.550000,128,1896784,48.73,4731.72
2576,11706.046206,52,1896836,48.72,4731.72
2577,11800.910920,143,1896979,48.75,4731.72
2578,11796.063388,67,1897046,48.73,4731.72
2579,11906.346930,67,1897113,48.72,4731.72
2580,12027.766553,55,1897168,48.70,4731.72
2581,12183.454191,74,1897242,48.69,4731.72
2582,12403.442818,67,1897309,48.67,4731.72
2583,12774.294977,61,1897370,48.66,4731.72
2584,12887.373336,7,1897377,48.64,4731.72
2585,13285.972270,63,1897440,48.62,4731.72
2586,13450.938407,83,1897523,48.68,4732.49
2587,13545.884776,70,1897593,48.67,4732.49
2588,13668.898682,125,1897718,48.66,4732.49
2589,13875.350921,68,1897786,48.66,4736.76
2590,13795.519575,73,1897859,48.66,4746.65
2591,13676.010267,126,1897985,48.65,4746.65
2592,13663.622803,64,1898049,48.63,4746.65
2593,13775.970282,65,1898114,48.62,4746.65
2594,13911.591084,102,1898216,48.60,4746.65
2595,14042.146097,25,1898241,48.59,4746.65
2596,14171.054678,64,1898305,48.57,4746.65
2597,14333.248428,64,1898369,48.55,4746.65
2598,0.000000,0,1898369,48.54,4746.65
2599,0.000000,0,1898369,48.52,4746.65
2600,14726.951882,75,1898444,48.50,4746.65
2601,0.000000,0,1898444,48.57,4749.95
2602,0.000000,0,1898444,48.55,4749.95
2603,15675.511395,340,1898784,48.54,4749.95
2604,0.000000,0,1898784,48.52,4749.95
2605,0.000000,0,1898784,48.51,4749.95
2606,0.000000,0,1898784,48.50,4749.95
2607,16224.864545,269,1899053,48.48,4749.95
2608,0.000000,0,1899053,48.47,4749.95
2609,0.000000,0,1899053,48.45,4749.95
2610,16297.362292,191,1899244,48.43,4749.95
2611,13776.122106,125,1899369,48.42,4749.95
2612,8788.879346,455,1899824,48.40,4749.95
2613,5472.293402,259,1900083,48.39,4749.95
2614,3552.425828,259,1900342,48.37,4749.95
2615,3365.590156,195,1900537,48.39,4749.95
2616,3903.745913,288,1900825,48.47,4749.95
2617,4000.439523,259,1901084,48.45,4749.95
2618,3996.111803,263,1901347,48.44,4749.95
2619,4078.872029,190,1901537,48.42,4749.95
2620,4178.858225,286,1901823,48.41,4749.95
2621,4225.642738,196,1902019,48.39,4749.95
2622,4286.255236,260,1902279,48.38,4749.95
2623,4268.435070,215,1902494,48.37,4749.95
2624,4314.664962,241,1902735,48.35,4749.95
2625,4325.375771,219,1902954,48.34,4749.95
2626,4322.728213,196,1903150,48.32,4749.95
2627,4588.486466,258,1903408,48.31,4749.95
2628,4657.534614,195,1903603,48.30,4749.95
2629,4651.374100,182,1903785,48.34,4749.95
2630,5013.725879,169,1903954,48.39,4749.95
2631,5126.628069,196,1904150,48.41,4749.95
2632,5167.131188,196,1904346,48.41,4749.95
2633,5124.895326,257,1904603,48.41,4749.95
2634,5064.037573,132,1904735,48.41,4749.95
2635,4995.605356,219,1904954,48.40,4749.95
2636,5054.283431,132,1905086,48.43,4755.84
2637,5021.001842,260,1905346,48.44,4756.79
2638,5081.180598,149,1905495,48.44,4756.79
2639,5135.499717,244,1905739,48.43,4756.79
2640,5158.001281,156,1905895,48.42,4756.79
2641,5223.250916,189,1906084,48.40,4756.79
2642,5260.652560,196,1906280,48.39,4756.79
2643,5252.336653,202,1906482,48.37,4756.79
2644,5372.338331,187,1906669,48.36,4756.79
2645,5404.842690,160,1906829,48.42,4756.79
2646,5332.570160,193,1907022,48.41,4756.79
2647,5451.476908,132,1907154,48.39,4756.79
2648,5700.220681,194,1907348,48.38,4756.79
2649,5651.374586,134,1907482,48.41,4756.79
2650,5881.904112,187,1907669,48.39,4756.79
2651,6036.114637,156,1907825,48.38,4756.79
2652,6095.501944,196,1908021,48.36,4756.79
2653,6097.398087,133,1908154,48.35,4756.79
2654,6180.407293,191,1908345,48.33,4756.79
2655,6290.724145,134,1908479,48.32,4756.79
2656,6183.350908,149,1908628,48.30,4756.79
2657,6242.876888,173,1908801,48.29,4756.79
2658,6308.436177,154,1908955,48.27,4756.79
2659,6442.514390,131,1909086,48.30,4756.79
2660,6372.605858,135,1909221,48.33,4756.79
2661,6418.656488,193,1909414,48.31,4756.79
2662,6376.805929,135,1909549,48.30,4756.79
2663,6490.449721,186,1909735,48.28,4756.79
2664,6495.661335,98,1909833,48.27,4756.79
2665,6545.088170,188,1910021,48.25,4756.79
2666,6537.981513,134,1910155,48.24,4756.79
2667,6523.915512,191,1910346,48.22,4756.79
2668,6541.126786,137,1910483,48.21,4756.79
2669,6480.783973,146,1910629,48.19,4756.79
2670,6552.711618,111,1910740,48.17,4756.79
2671,6475.383621,216,1910956,48.16,4756.79
2672,6416.904574,131,1911087,48.14,4756.79
2673,6398.676443,198,1911285,48.13,4756.79
2674,6392.467491,130,1911415,48.17,4756.79
2675,6395.322874,200,1911615,48.18,4756.79
2676,6431.435097,122,1911737,48.16,4756.79
2677,6348.292189,102,1911839,48.15,4756.79
2678,6386.869617,185,1912024,48.14,4756.79
2679,6384.854220,196,1912220,48.12,4756.79
2680,6297.302261,139,1912359,48.11,4756.79
2681,6261.378420,191,1912550,48.09,4756.79
2682,6287.002810,123,1912673,48.07,4756.79
2683,6274.305790,160,1912833,48.06,4756.79
2684,6340.090822,188,1913021,48.05,4756.79
2685,6361.528566,70,1913091,48.03,4756.79
2686,6361.419456,255,1913346,48.02,4756.79
2687,6360.587773,134,1913480,48.00,4756.79
2688,6258.693196,150,1913630,48.03,4756.79
2689,6284.867567,174,1913804,48.07,4756.79
2690,6347.363631,153,1913957,48.08,4756.79
2691,6288.785404,132,1914089,48.06,4756.79
2692,6301.035367,197,1914286,48.05,4756.79
2693,6215.669711,130,1914416,48.04,4756.79
2694,6248.553881,201,1914617,48.02,4756.79
2695,6336.198561,120,1914737,48.00,4756.79
2696,6361.396664,104,1914841,47.99,4756.79
2697,6342.882166,187,1915028,47.98,4756.79
2698,6345.211716,193,1915221,47.96,4756.79
2699,6343.574902,138,1915359,47.95,4756.79
2700,6389.636242,190,1915549,47.93,4756.79
2701,6355.992273,126,1915675,47.92,4756.79
2702,6331.610030,130,1915805,47.91,4756.79
2703,6395.958126,153,1915958,47.97,4756.79
2704,6407.702660,135,1916093,47.99,4756.79
2705,6377.454635,254,1916347,47.98,4756.79
2706,6323.699606,136,1916483,47.96,4756.79
2707,6389.023448,146,1916629,47.95,4756.79
2708,6456.360396,113,1916742,47.94,4756.79
2709,6524.820240,103,1916845,47.92,4756.79
2710,6484.508264,243,1917088,47.91,4756.79
2711,6526.034903,136,1917224,47.90,4756.79
2712,6463.021284,136,1917360,47.88,4756.79
2713,6486.213382,254,1917614,47.86,4756.79
2714,6439.331258,63,1917677,47.85,4757.05
2715,6451.942012,129,1917806,47.83,4757.05
2716,6588.941335,154,1917960,47.82,4757.05
2717,6697.704790,130,1918090,47.84,4757.05
2718,6757.084502,137,1918227,47.87,4757.40
2719,6946.864209,189,1918416,47.90,4757.40
2720,6903.845686,200,1918616,47.88,4757.40
2721,7061.858822,62,1918678,47.87,4757.40
2722,6948.870836,163,1918841,47.85,4757.40
2723,6891.805965,119,1918960,47.84,4757.40
2724,6877.125409,133,1919093,47.82,4757.40
2725,6816.994151,179,1919272,47.81,4757.40
2726,6881.453038,145,1919417,47.80,4757.40
2727,7033.904232,199,1919616,47.78,4757.40
2728,7033.392465,62,1919678,47.78,4757.40
2729,6995.532629,163,1919841,47.79,4757.40
2730,6954.363348,120,1919961,47.80,4757.40
2731,7070.332564,132,1920093,47.89,4757.40
2732,6864.512474,243,1920336,47.94,4757.40
2733,6883.445128,147,1920483,47.95,4757.40
2734,6822.552969,134,1920617,47.96,4757.40
2735,6847.468197,61,1920678,47.96,4757.40
2736,6824.936945,163,1920841,47.97,4757.40
2737,6782.569934,186,1921027,47.98,4758.02
2738,6829.376682,67,1921094,48.05,4765.23
2739,6955.029215,242,1921336,48.07,4765.23
2740,6945.380732,83,1921419,48.07,4765.23
2741,7073.636204,198,1921617,48.05,4765.23
2742,7119.627420,61,1921678,48.04,4765.23
2743,7022.208016,163,1921841,48.03,4765.23
2744,7035.835507,122,1921963,48.01,4765.23
2745,7083.139669,196,1922159,47.99,4765.23
2746,7000.521474,178,1922337,47.98,4765.23
2747,6939.874867,84,1922421,48.01,4765.23
2748,6951.690974,197,1922618,48.00,4765.23
2749,7002.623230,61,1922679,47.98,4765.23
2750,7004.041194,167,1922846,47.97,4765.23
2751,6953.016916,181,1923027,47.97,4765.23
2752,6792.346612,132,1923159,47.98,4765.23
2753,6894.487550,179,1923338,48.00,4776.16
2754,6907.760343,84,1923422,47.99,4776.16
2755,7079.693864,195,1923617,47.98,4776.16
2756,7039.534638,63,1923680,47.96,4776.16
2757,7150.269108,166,1923846,47.95,4776.16
2758,7023.631360,119,1923965,47.93,4776.16
2759,7068.261870,195,1924160,47.92,4776.16
2760,7028.609216,68,1924228,47.91,4776.16
2761,7850.641609,65,1924293,47.89,4776.16
2762,0.000000,0,1924293,47.91,4776.16
2763,0.000000,0,1924293,47.90,4776.16
2764,9833.342603,194,1924487,47.88,4776.16
2765,0.000000,0,1924487,47.87,4776.16
2766,0.000000,0,1924487,47.85,4776.16
2767,0.000000,0,1924487,47.84,4776.16
2768,0.000000,0,1924487,47.83,4776.16
2769,0.000000,0,1924487,47.81,4776.16
2770,11871.405342,927,1925414,47.79,4776.16
2771,0.000000,0,1925414,47.78,4776.16
2772,0.000000,0,1925414,47.77,4776.16
2773,8834.700183,64,1925478,47.75,4776.16
2774,0.000000,0,1925478,47.73,4776.16
2775,0.000000,0,1925478,47.71,4776.16
2776,6629.548531,64,1925542,47.70,4776.16
2777,0.000000,0,1925542,47.68,4776.16
2778,0.000000,0,1925542,47.67,4776.16
2779,0.000000,0,1925542,47.67,4776.16
2780,0.000000,0,1925542,47.66,4776.16
2781,10145.868140,65,1925607,47.66,4776.16
2782,0.000000,0,1925607,47.65,4776.16
2783,0.000000,0,1925607,47.65,4776.16
2784,0.000000,0,1925607,47.68,4776.16
2785,0.000000,0,1925607,47.68,4776.16
2786,0.000000,0,1925607,47.67,4776.16
2787,16671.891715,130,1925737,47.67,4776.16
2788,17681.332975,455,1926192,47.67,4776.16
2789,13018.631498,519,1926711,47.66,4776.16
2790,1919.262078,455,1927166,47.65,4776.16
2791,1991.473613,520,1927686,47.64,4776.16
2792,2174.227711,455,1928141,47.68,4776.16
2793,2113.214340,518,1928659,47.69,4776.16
2794,1847.569453,522,1929181,47.72,4776.16
2795,1830.982339,520,1929701,47.71,4776.16
2796,2277.098508,389,1930090,47.70,4776.16
2797,2145.588594,650,1930740,47.69,4776.16
2798,1730.194652,455,1931195,47.68,4776.16
2799,1881.566582,520,1931715,47.66,4776.16
2800,1979.477643,455,1932170,47.69,4776.16
2801,2036.609682,455,1932625,47.68,4776.16
2802,2015.958993,585,1933210,47.67,4776.16
2803,1896.020682,454,1933664,47.66,4776.16
2804,1965.193597,390,1934054,47.65,4776.16
2805,2056.180825,454,1934508,47.64,4776.16
2806,2314.396583,260,1934768,47.63,4776.16
2807,2961.349024,326,1935094,47.65,4776.16
2808,3388.163450,259,1935353,47.67,4776.16
2809,3812.834614,261,1935614,47.66,4776.16
2810,3814.130743,324,1935938,47.68,4776.16
2811,3800.775569,195,1936133,47.67,4776.16
2812,4393.586148,1,1936134,47.65,4776.16
2813,5700.675028,64,1936198,47.64,4776.16
2814,0.000000,0,1936198,47.62,4776.16
2815,7291.007615,1,1936199,47.61,4776.16
2816,0.000000,0,1936199,47.59,4776.16
2817,8765.729657,63,1936262,47.58,4776.16
2818,10283.313497,1,1936263,47.57,4776.16
2819,0.000000,0,1936263,47.55,4776.16
2820,11684.095587,25,1936288,47.53,4776.16
2821,0.000000,0,1936288,47.56,4776.16
2822,13443.805368,64,1936352,47.54,4776.16
2823,14235.107399,257,1936609,47.52,4776.16
2824,13555.097720,512,1937121,47.51,4776.16
2825,9155.593370,169,1937290,47.50,4776.16
2826,3223.021330,255,1937545,47.49,4776.16
2827,3474.433127,256,1937801,47.48,4776.16
2828,3935.987717,207,1938008,47.46,4776.16
2829,4409.128549,254,1938262,47.48,4776.16
2830,4885.460081,90,1938352,47.47,4776.16
2831,5180.130893,74,1938426,47.46,4776.16
2832,5476.565405,183,1938609,47.45,4776.16
2833,5863.264046,130,1938739,47.43,4776.16
2834,6170.142822,191,1938930,47.42,4776.16
2835,6501.788251,130,1939060,47.40,4776.16
2836,6914.202719,189,1939249,47.43,4776.16
2837,7296.936853,39,1939288,47.41,4776.16
2838,7643.081683,66,1939354,47.40,4776.16
2839,7980.674917,66,1939420,47.38,4776.16
2840,8206.664573,127,1939547,47.41,4776.16
2841,8635.546722,65,1939612,47.39,4776.16
2842,8840.405082,129,1939741,47.38,4776.16
2843,9211.002144,126,1939867,47.37,4776.16
2844,9700.134290,126,1939993,47.35,4776.16
2845,9896.487679,67,1940060,47.34,4776.16
2846,10217.751015,126,1940186,47.33,4776.16
2847,10437.112564,78,1940264,47.31,4776.16
2848,10667.840629,26,1940290,47.30,4776.16
2849,10494.403809,133,1940423,47.28,4776.93
2850,9023.904092,315,1940738,47.27,4776.93
2851,8651.666810,65,1940803,47.33,4778.82
2852,8941.238219,66,1940869,47.32,4778.82
2853,8853.474338,127,1940996,47.33,4778.82
2854,8942.306109,65,1941061,47.33,4778.82
2855,8950.636661,128,1941189,47.31,4778.82
2856,8827.000591,76,1941265,47.30,4778.82
2857,8814.937125,28,1941293,47.29,4778.82
2858,8914.106175,131,1941424,47.27,4778.82
2859,9080.515133,313,1941737,47.26,4778.82
2860,9106.544729,65,1941802,47.24,4778.82
2861,9108.915718,65,1941867,47.23,4778.82
2862,9098.518932,126,1941993,47.22,4778.82
2863,9119.894335,67,1942060,47.21,4778.82
2864,9117.798065,126,1942186,47.19,4778.82
2865,9114.920809,78,1942264,47.18,4778.82
2866,9123.314072,28,1942292,47.24,4788.04
2867,9202.364773,68,1942360,47.22,4788.04
2868,9188.054758,316,1942676,47.23,4788.04
2869,9152.556688,126,1942802,47.24,4788.04
2870,9104.734219,65,1942867,47.22,4788.04
2871,9209.616269,65,1942932,47.22,4788.04
2872,9165.084802,128,1943060,47.22,4788.04
2873,9100.769084,128,1943188,47.23,4788.04
2874,9122.764480,75,1943263,47.23,4788.04
2875,9088.629622,26,1943289,47.24,4788.04
2876,9122.410134,70,1943359,47.26,4788.04
2877,9174.076610,259,1943618,47.31,4788.04
2878,9162.301926,128,1943746,47.35,4788.04
2879,9100.575869,64,1943810,47.36,4788.04
2880,9087.691521,122,1943932,47.37,4788.04
2881,9085.507383,126,1944058,47.41,4788.04
2882,9153.591566,128,1944186,47.42,4788.04
2883,9110.363226,67,1944253,47.42,4788.04
2884,9162.592775,35,1944288,47.40,4788.04
2885,9009.092659,71,1944359,47.39,4788.04
2886,8971.050407,257,1944616,47.41,4788.04
2887,9169.399178,129,1944745,47.40,4788.04
2888,9182.297613,64,1944809,47.42,4788.04
2889,9207.414840,121,1944930,47.42,4788.04
2890,9211.780024,70,1945000,47.40,4788.04
2891,9165.232057,126,1945126,47.39,4788.04
2892,9157.380761,127,1945253,47.37,4788.04
2893,8989.810328,39,1945292,47.36,4788.04
2894,8952.501692,67,1945359,47.35,4788.04
2895,8976.723186,258,1945617,47.34,4788.04
2896,8997.996480,128,1945745,47.36,4788.04
2897,8946.830490,64,1945809,47.35,4788.04
2898,8956.006766,121,1945930,47.33,4788.04
2899,8951.975886,128,1946058,47.32,4788.04
2900,9053.083531,68,1946126,47.31,4788.04
2901,8944.082414,127,1946253,47.31,4799.38
2902,0.000000,0,1946253,47.32,4802.87
2903,0.000000,0,1946253,47.30,4802.87
2904,9588.324782,238,1946491,47.29,4802.87
2905,10372.488461,4,1946495,47.27,4802.87
2906,9709.117620,307,1946802,47.26,4802.87
2907,0.000000,0,1946802,47.24,4802.87
2908,9725.945208,197,1946999,47.23,4802.87
2909,0.000000,0,1946999,47.21,4802.87
2910,0.000000,0,1946999,47.20,4802.87
2911,0.000000,0,1946999,47.20,4802.87
2912,0.000000,0,1946999,47.20,4802.87
2913,0.000000,0,1946999,47.19,4802.87
2914,0.000000,0,1946999,47.17,4802.87
2915,0.000000,0,1946999,47.16,4802.87
2916,0.000000,0,1946999,47.14,4802.87
2917,14694.196161,514,1947513,47.13,4802.87
2918,0.000000,0,1947513,47.12,4802.87
2919,0.000000,0,1947513,47.10,4802.87
2920,14846.366877,52,1947565,47.08,4802.87
2921,15028.771851,13,1947578,47.10,4802.87
2922,0.000000,0,1947578,47.09,4802.87
2923,0.000000,0,1947578,47.07,4802.87
2924,18951.564671,65,1947643,47.06,4802.87
2925,0.000000,0,1947643,47.04,4802.87
2926,0.000000,0,1947643,47.03,4802.87
2927,0.000000,0,1947643,47.01,4802.87
2928,22416.356548,65,1947708,47.00,4802.87
2929,22181.847028,260,1947968,46.98,4802.87
2930,13793.591171,389,1948357,46.97,4802.87
2931,6693.382730,597,1948954,46.96,4802.87
2932,1947.456770,508,1949462,46.95,4802.87
2933,2080.234539,520,1949982,46.94,4802.87
2934,1971.045173,455,1950437,46.94,4802.87
2935,1823.389795,520,1950957,46.95,4802.87
2936,2179.435780,519,1951476,46.98,4802.87
2937,1975.350386,259,1951735,46.97,4802.87
2938,1963.534939,455,1952190,46.98,4802.87
2939,2069.620835,779,1952969,46.98,4802.87
2940,2091.417784,388,1953357,46.98,4802.87
2941,2124.594255,576,1953933,47.04,4802.87
2942,1649.379341,530,1954463,47.05,4802.87
2943,2179.862226,454,1954917,47.07,4802.87
2944,1931.771651,585,1955502,47.09,4802.87
2945,1539.680874,325,1955827,47.08,4802.87
2946,2097.831648,571,1956398,47.08,4802.87
2947,1920.710221,533,1956931,47.10,4802.87
2948,2368.491695,196,1957127,47.09,4802.87
2949,2839.987619,324,1957451,47.07,4802.87
2950,3355.987131,261,1957712,47.06,4802.87
2951,3783.768718,194,1957906,47.05,4802.87
2952,3913.777353,261,1958167,47.04,4802.87
2953,3817.739976,260,1958427,47.02,4802.87
2954,4078.905679,219,1958646,47.01,4802.87
2955,4231.371246,260,1958906,47.00,4802.87
2956,4219.747618,260,1959166,47.03,4802.87
2957,4279.433200,197,1959363,47.02,4802.87
2958,4381.104786,193,1959556,47.02,4802.87
2959,4348.274991,221,1959777,47.03,4802.87
2960,4327.531976,259,1960036,47.05,4806.90
2961,4361.246391,261,1960297,47.04,4806.90
2962,4367.339524,197,1960494,47.03,4806.90
2963,4418.374009,219,1960713,47.02,4806.90
2964,4541.676931,242,1960955,47.00,4806.90
2965,4454.490578,150,1961105,46.99,4806.90
2966,4702.293403,258,1961363,46.98,4806.90
2967,4640.884297,258,1961621,46.97,4806.90
2968,4793.408994,27,1961648,46.96,4806.90
2969,5335.871957,64,1961712,46.94,4806.90
2970,6637.394952,1,1961713,46.93,4806.90
2971,7407.384973,66,1961779,46.93,4806.90
2972,7404.408479,260,1962039,46.94,4806.90
2973,7474.727247,194,1962233,46.92,4806.90
2974,7680.477645,197,1962430,46.94,4806.90
2975,7707.444336,192,1962622,46.94,4806.90
2976,7215.518470,94,1962716,46.92,4806.90
2977,5505.149207,131,1962847,46.91,4806.90
2978,5978.171845,189,1963036,46.89,4806.90
2979,6483.960824,73,1963109,46.88,4806.90
2980,6642.797476,126,1963235,46.87,4806.90
2981,6886.687404,192,1963427,46.86,4806.90
2982,7260.327859,70,1963497,46.85,4806.90
2983,7524.407677,154,1963651,46.83,4806.90
2984,7798.323177,126,1963777,46.82,4806.90
2985,7817.496368,129,1963906,46.80,4806.98
2986,7874.627654,134,1964040,46.81,4806.98
2987,7746.692679,132,1964172,46.81,4806.98
2988,7739.500303,127,1964299,46.80,4806.98
2989,7814.527411,132,1964431,46.82,4806.98
2990,7694.746277,130,1964561,46.81,4806.98
2991,7703.299964,152,1964713,46.80,4806.98
2992,7707.468129,67,1964780,46.79,4806.98
2993,7771.051207,129,1964909,46.77,4806.98
2994,7820.198701,132,1965041,46.76,4788.70
2995,7899.466192,132,1965173,46.75,4788.70
2996,7953.381297,128,1965301,46.73,4788.70
2997,7832.323065,135,1965436,46.72,4788.70
2998,7866.136096,191,1965627,46.71,4788.70
2999,7790.868895,88,1965715,46.70,4788.70
3000,7703.417858,68,1965783,46.68,4788.70
3001,7720.590741,175,1965958,46.69,4788.70
3002,7693.104626,84,1966042,46.73,4788.70
3003,7760.611892,137,1966179,46.72,4788.70
3004,7866.283830,122,1966301,46.74,4788.70
3005,7929.651164,137,1966438,46.73,4788.70
3006,7878.815409,210,1966648,46.72,4788.70
3007,7836.373527,69,1966717,46.70,4788.70
3008,7897.835348,130,1966847,46.69,4788.70
3009,7872.333305,176,1967023,46.68,4788.70
3010,7837.627031,83,1967106,46.67,4788.70
3011,7804.199483,79,1967185,46.66,4788.70
3012,7701.770752,180,1967365,46.64,4788.70
3013,7688.461801,134,1967499,46.63,4788.70
3014,7691.650277,152,1967651,46.62,4788.70
3015,7692.428208,127,1967778,46.61,4788.70
3016,7806.412107,114,1967892,46.63,4788.70
3017,7752.215105,146,1968038,46.66,4788.70
3018,7802.366888,73,1968111,46.65,4788.70
3019,7751.275922,188,1968299,46.64,4788.70
3020,7816.130219,134,1968433,46.66,4788.70
3021,7758.963845,128,1968561,46.65,4788.70
3022,7703.886784,153,1968714,46.64,4788.70
3023,7798.407369,69,1968783,46.62,4788.70
3024,7678.311831,129,1968912,46.61,4788.70
3025,7570.344393,130,1969042,46.60,4788.70
3026,7697.812944,132,1969174,46.59,4788.70
3027,7735.133188,127,1969301,46.57,4788.70
3028,7755.879094,134,1969435,46.56,4788.70
3029,7693.370649,188,1969623,46.55,4788.70
3030,7689.473217,92,1969715,46.53,4788.70
3031,7705.170768,71,1969786,46.55,4788.70
3032,7703.865533,237,1970023,46.58,4788.70
3033,7689.492451,22,1970045,46.58,4789.05
3034,7668.772729,140,1970185,46.61,4789.05
3035,7657.928031,119,1970304,46.61,4789.05
3036,7714.447703,133,1970437,46.61,4789.05
3037,7794.535479,211,1970648,46.60,4789.05
3038,7773.003417,71,1970719,46.60,4789.05
3039,7760.970407,131,1970850,46.61,4789.05
3040,7883.045660,173,1971023,46.62,4789.05
3041,7891.314004,86,1971109,46.62,4789.05
3042,7898.851873,76,1971185,46.67,4789.13
3043,7906.795845,119,1971304,46.72,4789.13
3044,7954.947414,155,1971459,46.72,4789.13
3045,7857.798867,193,1971652,46.72,4789.13
3046,7842.230592,71,1971723,46.73,4789.13
3047,7858.247128,127,1971850,46.75,4789.13
3048,7940.514116,189,1972039,46.75,4789.13
3049,7781.535456,71,1972110,46.75,4789.13
3050,7813.619851,76,1972186,46.75,4789.13
3051,7989.266385,183,1972369,46.76,4789.13
3052,7945.196751,132,1972501,46.76,4789.13
3053,7951.978136,152,1972653,46.74,4789.13
3054,7934.823936,70,1972723,46.73,4789.13
3055,8123.284070,127,1972850,46.76,4789.13
3056,7938.601767,189,1973039,46.75,4789.13
3057,7931.784998,72,1973111,46.74,4789.13
3058,7926.772933,77,1973188,46.72,4789.13
3059,7909.824606,181,1973369,46.71,4789.13
3060,7918.909725,90,1973459,46.70,4789.13
3061,7984.538426,194,1973653,46.68,4789.13
3062,7923.730781,70,1973723,46.71,4789.13
3063,7914.196803,62,1973785,46.70,4789.13
3064,8362.484722,194,1973979,46.68,4789.13
3065,0.000000,0,1973979,46.67,4789.13
3066,0.000000,0,1973979,46.66,4789.66
3067,0.000000,0,1973979,46.68,4799.56
3068,0.000000,0,1973979,46.66,4799.56
3069,9828.279301,587,1974566,46.65,4799.56
3070,8973.430316,149,1974715,46.64,4799.56
3071,0.000000,0,1974715,46.63,4799.56
3072,8400.428699,244,1974959,46.62,4799.56
3073,0.000000,0,1974959,46.61,4799.56
3074,0.000000,0,1974959,46.61,4799.56
3075,0.000000,0,1974959,46.60,4799.56
3076,0.000000,0,1974959,46.63,4799.56
3077,0.000000,0,1974959,46.63,4799.56
3078,10250.537713,260,1975219,46.62,4799.56
3079,0.000000,0,1975219,46.62,4799.56
3080,0.000000,0,1975219,46.62,4799.56
3081,0.000000,0,1975219,46.62,4799.56
3082,0.000000,0,1975219,46.61,4809.42
3083,0.000000,0,1975219,46.60,4817.93
3084,0.000000,0,1975219,46.59,4817.93
3085,0.000000,0,1975219,46.58,4817.93
3086,0.000000,0,1975219,46.56,4817.93
3087,0.000000,0,1975219,46.55,4817.93
3088,0.000000,0,1975219,46.54,4817.93
3089,0.000000,0,1975219,46.52,4817.93
3090,0.000000,0,1975219,46.51,4817.93
3091,0.000000,0,1975219,46.49,4817.93
3092,21450.944296,779,1975998,46.48,4817.93
3093,7914.864834,455,1976453,46.47,4817.93
3094,2049.607092,520,1976973,46.46,4817.93
3095,1866.206022,352,1977325,46.49,4817.93
3096,2041.633444,623,1977948,46.51,4817.93
3097,1903.719334,520,1978468,46.50,4817.93
3098,2048.292558,520,1978988,46.49,4817.93
3099,1990.116525,455,1979443,46.48,4817.93
3100,1850.517732,454,1979897,46.47,4817.93
3101,2004.987364,585,1980482,46.47,4817.93
3102,1962.762221,325,1980807,46.46,4817.93
3103,2105.565348,715,1981522,46.48,4823.38
3104,1945.848390,325,1981847,46.47,4823.38
3105,2009.609103,194,1982041,46.46,4823.38
3106,3597.202839,1,1982042,46.45,4823.38
3107,0.000000,0,1982042,46.43,4823.38
3108,0.000000,0,1982042,46.45,4823.38
3109,6096.831111,64,1982106,46.44,4823.38
3110,0.000000,0,1982106,46.43,4823.38
3111,0.000000,0,1982106,46.42,4823.38
3112,9487.152780,1,1982107,46.40,4823.38
3113,0.000000,0,1982107,46.39,4823.38
3114,11549.541750,103,1982210,46.38,4823.38
3115,11502.950278,512,1982722,46.36,4823.38
3116,10753.010689,385,1983107,46.38,4823.38
3117,2573.245593,167,1983274,46.37,4823.38
3118,3184.857946,193,1983467,46.36,4823.38
3119,3624.145785,256,1983723,46.35,4823.38
3120,4106.325686,319,1984042,46.34,4823.38
3121,4482.442346,105,1984147,46.33,4823.38
3122,4870.286006,130,1984277,46.33,4823.38
3123,4937.036544,190,1984467,46.34,4823.38
3124,5308.602944,129,1984596,46.33,4823.38
3125,5681.975752,191,1984787,46.32,4823.38
3126,6004.310816,139,1984926,46.31,4823.38
3127,6394.066021,181,1985107,46.33,4823.38
3128,6667.452359,46,1985153,46.31,4823.38
3129,6974.356744,122,1985275,46.30,4823.38
3130,7504.408627,66,1985341,46.29,4823.38
3131,7774.207231,128,1985469,46.27,4823.38
3132,8042.060982,127,1985596,46.26,4823.38
3133,8301.852142,127,1985723,46.25,4823.38
3134,8560.924480,127,1985850,46.24,4823.38
3135,8823.049878,130,1985980,46.23,4823.56
3136,8999.977942,127,1986107,46.22,4823.56
3137,9195.230269,40,1986147,46.21,4823.56
3138,7873.710995,349,1986496,46.26,4823.56
3139,6467.074454,164,1986660,46.25,4823.56
3140,6412.360158,128,1986788,46.24,4823.56
3141,6299.845245,129,1986917,46.25,4823.90
3142,6300.886030,129,1987046,46.26,4824.24
3143,6248.414350,100,1987146,46.25,4824.24
3144,6348.994064,222,1987368,46.23,4822.50
3145,6729.166392,227,1987595,46.22,4822.50
3146,6750.960016,127,1987722,46.21,4822.50
3147,6741.121665,130,1987852,46.20,4822.50
3148,6632.731963,72,1987924,46.19,4822.50
3149,6774.090220,183,1988107,46.17,4822.50
3150,6729.327356,42,1988149,46.16,4822.50
3151,6766.076778,220,1988369,46.15,4822.50
3152,6761.700723,229,1988598,46.14,4822.50
3153,6786.909783,127,1988725,46.18,4822.50
3154,6771.102921,131,1988856,46.18,4823.56
3155,6762.157746,135,1988991,46.17,4823.56
3156,6940.101548,118,1989109,46.16,4823.56
3157,6817.544703,68,1989177,46.17,4823.56
3158,6876.216990,257,1989434,46.17,4823.56
3159,6881.093823,166,1989600,46.16,4823.56
3160,6861.453220,127,1989727,46.15,4823.56
3161,6823.147835,129,1989856,46.14,4823.56
3162,6879.741150,136,1989992,46.13,4823.56
3163,6825.446521,119,1990111,46.11,4823.56
3164,6829.351439,66,1990177,46.10,4823.56
3165,7015.433896,259,1990436,46.09,4823.56
3166,6961.395912,164,1990600,46.08,4823.82
3167,6960.516633,128,1990728,46.07,4823.82
3168,6942.954403,151,1990879,46.07,4823.82
3169,7069.782056,113,1990992,46.11,4823.82
3170,7006.241476,119,1991111,46.10,4823.82
3171,6962.447968,67,1991178,46.09,4823.82
3172,7114.911760,193,1991371,46.08,4823.82
3173,7259.519492,228,1991599,46.10,4823.82
3174,7206.164792,127,1991726,46.09,4823.82
3175,7193.974853,129,1991855,46.08,4823.82
3176,7219.627163,73,1991928,46.07,4823.82
3177,7311.262625,182,1992110,46.06,4823.82
3178,7225.464307,66,1992176,46.05,4823.82
3179,7189.947438,101,1992277,46.05,4823.82
3180,7284.803854,286,1992563,46.05,4823.82
3181,7219.907416,99,1992662,46.08,4823.82
3182,7337.345998,191,1992853,46.08,4823.82
3183,7200.323264,71,1992924,46.08,4823.82
3184,7249.053047,127,1993051,46.12,4823.82
3185,7234.508999,98,1993149,46.11,4823.82
3186,7229.332949,128,1993277,46.11,4823.82
3187,7283.128586,227,1993504,46.11,4823.82
3188,7381.204591,157,1993661,46.14,4825.75
3189,7315.225364,76,1993737,46.17,4825.75
3190,7424.814738,144,1993881,46.16,4825.75
3191,7373.450143,112,1993993,46.15,4825.75
3192,7328.791303,122,1994115,46.14,4825.75
3193,7331.017214,127,1994242,46.13,4825.75
3194,7411.227217,133,1994375,46.12,4825.75
3195,7309.444234,225,1994600,46.10,4825.75
3196,7370.482585,130,1994730,46.09,4825.75
3197,7331.872425,149,1994879,46.08,4825.75
3198,7334.058660,50,1994929,46.07,4825.75
3199,7363.829685,181,1995110,46.09,4825.75
3200,7379.536098,70,1995180,46.08,4825.75
3201,7336.315373,101,1995281,46.07,4825.75
3202,7410.764289,282,1995563,46.06,4825.75
3203,7350.877490,101,1995664,46.06,4825.75
3204,7335.699933,127,1995791,46.11,4826.11
3205,7285.931071,135,1995926,46.10,4826.11
3206,7210.326836,129,1996055,46.08,4826.11
3207,7209.964790,95,1996150,46.07,4826.11
3208,7209.442335,127,1996277,46.06,4826.11
3209,7209.363352,165,1996442,46.05,4826.11
3210,7511.057330,162,1996604,46.04,4826.11
3211,7510.693422,133,1996737,46.03,4826.11
3212,7469.532291,180,1996917,46.02,4826.11
3213,7438.470556,78,1996995,46.01,4826.11
3214,7493.207906,121,1997116,46.00,4826.11
3215,7425.213437,126,1997242,46.02,4826.11
3216,7474.377339,133,1997375,46.00,4826.11
3217,7543.061128,143,1997518,45.99,4826.11
3218,7703.884379,146,1997664,45.98,4826.11
3219,7588.727346,130,1997794,46.00,4826.11
3220,7635.022235,133,1997927,45.99,4826.11
3221,7546.721487,130,1998057,45.98,4826.11
3222,7611.823097,93,1998150,45.96,4826.11
3223,7622.362528,96,1998246,45.95,4826.11
3224,7583.270686,196,1998442,45.94,4826.11
3225,7614.370845,126,1998568,45.93,4826.11
3226,7555.663546,165,1998733,45.92,4826.11
3227,7594.603014,126,1998859,45.91,4826.11
3228,7604.301805,134,1998993,45.90,4826.11
3229,7609.057837,122,1999115,45.88,4826.11
3230,7516.470869,67,1999182,45.90,4826.96
3231,7520.013376,193,1999375,45.89,4826.96
3232,7512.695624,135,1999510,45.88,4826.96
3233,7638.494241,98,1999608,45.87,4826.96
3234,7633.579397,132,1999740,45.85,4826.96
3235,7636.795673,179,1999919,45.84,4826.96
3236,7633.121181,81,,,
